country,country_iso2,country_iso3,continent,year,num_distinct_articles,is_oa,bronze,green,gold,hybrid,bronze_green,bronze_gold,bronze_hybrid,green_gold,green_hybrid,gold_hybrid,bronze_green_gold,bronze_green_hybrid,bronze_gold_hybrid,green_gold_hybrid
Algeria,DZ,DZA,Africa,2019,336,54,8,18,32,10,26,40,18,36,28,42,44,36,50,46
Algeria,DZ,DZA,Africa,2018,1811,445,58,159,245,76,213,303,134,330,220,321,384,274,379,391
Algeria,DZ,DZA,Africa,2017,1683,456,73,185,178,120,236,251,193,303,287,298,354,338,371,405
Algeria,DZ,DZA,Africa,2016,1525,432,88,171,179,86,240,267,174,295,239,265,364,308,353,363
Algeria,DZ,DZA,Africa,2015,1344,382,54,131,159,116,175,213,170,233,236,275,277,280,329,338
Algeria,DZ,DZA,Africa,2014,1145,350,70,128,122,104,180,192,174,199,227,226,251,279,296,298
Algeria,DZ,DZA,Africa,2013,947,298,70,96,82,110,150,152,180,144,196,192,198,250,262,244
Algeria,DZ,DZA,Africa,2012,815,302,96,100,75,85,179,171,181,146,177,160,225,256,256,223
Algeria,DZ,DZA,Africa,2011,654,166,61,54,46,39,100,107,100,87,87,85,133,133,146,120
Algeria,DZ,DZA,Africa,2010,541,120,47,53,23,24,84,70,71,68,74,47,99,105,94,89
Algeria,DZ,DZA,Africa,2009,515,117,30,44,21,45,69,51,75,53,83,66,78,108,96,92
Benin,BJ,BEN,Africa,2019,140,59,2,46,41,12,47,43,14,54,50,53,55,51,55,58
Benin,BJ,BEN,Africa,2018,727,378,25,312,247,62,323,272,87,342,337,309,353,348,334,367
Benin,BJ,BEN,Africa,2017,771,457,65,359,254,65,391,319,130,395,389,319,427,421,384,425
Benin,BJ,BEN,Africa,2016,916,579,93,449,313,74,495,406,167,502,480,387,548,526,480,533
Benin,BJ,BEN,Africa,2015,864,517,113,395,253,64,450,366,177,433,424,317,488,479,430,462
Benin,BJ,BEN,Africa,2014,846,472,118,346,230,40,407,348,158,385,372,270,446,433,388,411
Benin,BJ,BEN,Africa,2013,827,446,114,349,225,32,408,339,146,377,359,257,436,418,371,387
Benin,BJ,BEN,Africa,2012,849,445,129,324,202,38,387,331,167,360,346,240,423,409,369,382
Benin,BJ,BEN,Africa,2011,727,372,95,274,162,42,319,257,137,304,297,204,349,342,299,327
Benin,BJ,BEN,Africa,2010,698,329,111,228,128,28,285,239,139,249,251,156,306,308,267,272
Benin,BJ,BEN,Africa,2009,717,340,120,210,127,25,282,247,145,248,230,152,320,302,272,268
Botswana,BW,BWA,Africa,2019,72,18,3,8,11,2,11,14,5,13,10,13,16,13,16,15
Botswana,BW,BWA,Africa,2018,479,193,22,93,115,41,110,137,63,142,127,156,159,144,178,176
Botswana,BW,BWA,Africa,2017,450,224,32,95,113,51,122,145,83,159,133,164,186,160,196,197
Botswana,BW,BWA,Africa,2016,389,202,30,86,93,61,111,123,91,125,138,154,150,163,184,177
Botswana,BW,BWA,Africa,2015,284,156,30,70,68,43,94,98,73,99,103,111,123,127,141,132
Botswana,BW,BWA,Africa,2014,338,187,40,84,93,36,116,133,76,129,110,129,161,142,169,155
Botswana,BW,BWA,Africa,2013,293,149,41,53,62,36,82,103,77,90,83,98,119,112,139,120
Botswana,BW,BWA,Africa,2012,264,99,34,35,34,20,63,68,54,54,52,54,82,80,88,71
Botswana,BW,BWA,Africa,2011,270,94,30,34,32,20,61,62,50,53,48,52,80,75,82,67
Botswana,BW,BWA,Africa,2010,203,50,22,23,17,6,41,39,28,27,28,23,45,46,45,32
Botswana,BW,BWA,Africa,2009,185,34,17,11,6,4,27,23,21,16,13,10,32,29,27,18
Burkina Faso,BF,BFA,Africa,2019,51,30,4,13,17,9,17,21,13,20,19,26,24,23,30,26
Burkina Faso,BF,BFA,Africa,2018,255,161,7,98,98,48,104,105,55,119,134,146,125,140,153,155
Burkina Faso,BF,BFA,Africa,2017,258,164,9,80,87,61,86,96,70,108,130,148,114,136,157,158
Burkina Faso,BF,BFA,Africa,2016,276,177,26,101,80,58,114,106,84,123,142,138,136,155,164,164
Burkina Faso,BF,BFA,Africa,2015,235,154,21,90,72,46,102,93,67,103,129,118,115,141,139,142
Burkina Faso,BF,BFA,Africa,2014,229,142,27,96,81,28,114,108,55,102,118,109,120,136,136,124
Burkina Faso,BF,BFA,Africa,2013,197,107,24,57,49,29,78,73,53,64,79,78,85,100,102,86
Burkina Faso,BF,BFA,Africa,2012,195,115,32,64,44,27,88,76,59,71,84,71,95,108,103,91
Burkina Faso,BF,BFA,Africa,2011,164,77,24,36,30,16,52,54,40,47,50,46,63,66,70,61
Burkina Faso,BF,BFA,Africa,2010,101,51,14,32,16,13,40,30,27,33,42,29,41,50,43,43
Burkina Faso,BF,BFA,Africa,2009,123,66,30,31,25,8,52,55,38,38,38,33,59,59,63,45
Burundi,BI,BDI,Africa,2019,3,1,0,0,1,0,0,1,0,1,0,1,1,0,1,1
Burundi,BI,BDI,Africa,2018,13,3,0,2,3,0,2,3,0,3,2,3,3,2,3,3
Burundi,BI,BDI,Africa,2017,18,6,0,3,4,1,3,4,1,5,4,5,5,4,5,6
Burundi,BI,BDI,Africa,2016,6,2,0,2,2,0,2,2,0,2,2,2,2,2,2,2
Burundi,BI,BDI,Africa,2015,9,3,1,3,2,0,3,3,1,3,3,2,3,3,3,3
Burundi,BI,BDI,Africa,2014,8,2,0,2,1,1,2,1,1,2,2,2,2,2,2,2
Burundi,BI,BDI,Africa,2013,2,1,1,0,0,0,1,1,1,0,0,0,1,1,1,0
Burundi,BI,BDI,Africa,2012,4,3,1,2,2,0,3,3,1,2,2,2,3,3,3,2
Burundi,BI,BDI,Africa,2011,6,1,0,1,1,0,1,1,0,1,1,1,1,1,1,1
Burundi,BI,BDI,Africa,2010,3,1,0,1,1,0,1,1,0,1,1,1,1,1,1,1
Burundi,BI,BDI,Africa,2009,3,1,0,1,1,0,1,1,0,1,1,1,1,1,1,1
Cameroon,CM,CMR,Africa,2019,206,89,5,42,62,19,47,67,24,69,57,81,74,62,86,84
Cameroon,CM,CMR,Africa,2018,1002,429,25,253,304,76,274,329,101,356,305,380,377,326,405,408
Cameroon,CM,CMR,Africa,2017,912,467,48,240,276,113,280,324,161,327,340,389,367,380,437,427
Cameroon,CM,CMR,Africa,2016,759,400,48,224,210,114,265,258,162,281,302,324,322,343,372,359
Cameroon,CM,CMR,Africa,2015,642,344,53,206,184,79,249,237,132,238,269,263,281,312,316,301
Cameroon,CM,CMR,Africa,2014,574,304,46,164,134,92,200,180,138,195,237,226,231,273,272,268
Cameroon,CM,CMR,Africa,2013,487,263,46,149,137,56,188,183,102,181,192,193,220,231,239,224
Cameroon,CM,CMR,Africa,2012,352,161,42,94,71,25,130,113,67,104,115,96,140,151,138,125
Cameroon,CM,CMR,Africa,2011,326,131,36,79,53,21,108,89,57,85,96,74,114,125,110,102
Cameroon,CM,CMR,Africa,2010,252,102,43,56,32,16,85,75,59,61,68,48,90,97,91,73
Cameroon,CM,CMR,Africa,2009,215,68,17,39,23,11,50,40,28,46,50,34,57,61,51,57
Cape Verde,CV,CPV,Africa,2018,5,3,0,2,1,1,2,1,1,3,2,2,3,2,2,3
Cape Verde,CV,CPV,Africa,2017,5,3,0,2,2,0,2,2,0,3,2,2,3,2,2,3
Cape Verde,CV,CPV,Africa,2016,5,4,0,3,1,1,3,1,1,3,4,2,3,4,2,4
Cape Verde,CV,CPV,Africa,2015,3,2,0,1,1,1,1,1,1,1,2,2,1,2,2,2
Cape Verde,CV,CPV,Africa,2014,7,5,1,3,2,0,4,3,1,4,3,2,5,4,3,4
Cape Verde,CV,CPV,Africa,2013,5,4,0,4,1,1,4,1,1,4,4,2,4,4,2,4
Cape Verde,CV,CPV,Africa,2012,1,1,0,1,0,1,1,0,1,1,1,1,1,1,1,1
Cape Verde,CV,CPV,Africa,2011,2,1,0,1,0,0,1,0,0,1,1,0,1,1,0,1
Cape Verde,CV,CPV,Africa,2010,2,1,0,1,0,0,1,0,0,1,1,0,1,1,0,1
Chad,TD,TCD,Africa,2018,13,5,1,3,3,1,4,4,2,4,3,4,5,4,5,4
Chad,TD,TCD,Africa,2017,9,5,0,4,3,1,4,3,1,4,5,4,4,5,4,5
Chad,TD,TCD,Africa,2016,12,4,1,1,1,1,2,2,2,2,2,2,3,3,3,3
Chad,TD,TCD,Africa,2015,15,9,2,5,3,1,7,5,3,6,6,4,8,8,6,7
Chad,TD,TCD,Africa,2014,9,2,0,2,1,1,2,1,1,2,2,2,2,2,2,2
Chad,TD,TCD,Africa,2013,9,5,1,3,3,0,4,4,1,4,3,3,5,4,4,4
Chad,TD,TCD,Africa,2012,8,3,1,3,0,0,3,1,1,3,3,0,3,3,1,3
Chad,TD,TCD,Africa,2011,9,3,0,3,1,1,3,1,1,3,3,2,3,3,2,3
Chad,TD,TCD,Africa,2010,9,2,0,2,1,1,2,1,1,2,2,2,2,2,2,2
Chad,TD,TCD,Africa,2009,10,2,0,1,1,0,1,1,0,2,1,1,2,1,1,2
Democratic Republic of the Congo,CD,COD,Africa,2019,40,25,1,18,19,4,19,20,5,21,21,23,22,22,24,24
Democratic Republic of the Congo,CD,COD,Africa,2018,275,146,12,110,95,31,120,107,43,130,116,126,140,126,138,136
Democratic Republic of the Congo,CD,COD,Africa,2017,335,216,29,147,126,45,169,155,74,176,165,171,198,187,200,194
Democratic Republic of the Congo,CD,COD,Africa,2016,260,171,32,125,90,29,147,122,61,139,135,119,161,157,151,149
Democratic Republic of the Congo,CD,COD,Africa,2015,244,163,23,137,97,12,152,120,35,143,142,109,158,157,132,148
Democratic Republic of the Congo,CD,COD,Africa,2014,254,176,30,134,106,12,154,136,42,149,141,118,169,161,148,156
Democratic Republic of the Congo,CD,COD,Africa,2013,185,122,26,86,63,12,101,89,38,99,94,75,114,109,101,107
Democratic Republic of the Congo,CD,COD,Africa,2012,165,90,21,62,54,4,77,75,25,72,65,58,87,80,79,75
Democratic Republic of the Congo,CD,COD,Africa,2011,98,51,9,47,29,3,50,38,12,47,48,32,50,51,41,48
Democratic Republic of the Congo,CD,COD,Africa,2010,116,44,15,36,16,2,42,31,17,37,37,18,43,43,33,38
Democratic Republic of the Congo,CD,COD,Africa,2009,83,39,16,28,11,3,38,27,19,28,29,14,38,39,30,29
Egypt,EG,EGY,Africa,2028,1,1,0,1,0,0,1,0,0,1,1,0,1,1,0,1
Egypt,EG,EGY,Africa,2019,3231,941,104,397,617,194,480,721,298,712,543,811,795,626,915,858
Egypt,EG,EGY,Africa,2018,17255,5346,721,2382,3150,1218,2953,3871,1939,3904,3253,4368,4475,3824,5089,4775
Egypt,EG,EGY,Africa,2017,16389,6053,1102,2456,2766,1719,3360,3868,2821,3739,3866,4485,4643,4770,5587,5149
Egypt,EG,EGY,Africa,2016,15226,6034,1056,2487,2667,1757,3305,3723,2813,3828,3875,4424,4646,4693,5480,5216
Egypt,EG,EGY,Africa,2015,13378,5130,1004,2159,2159,1505,2950,3163,2509,3121,3377,3664,3912,4168,4668,4339
Egypt,EG,EGY,Africa,2014,12342,4748,1053,1823,1840,1432,2639,2893,2485,2739,3016,3272,3555,3832,4325,3932
Egypt,EG,EGY,Africa,2013,10616,4028,869,1459,1500,1303,2149,2369,2172,2282,2515,2803,2972,3205,3672,3338
Egypt,EG,EGY,Africa,2012,8691,3292,843,1259,1163,959,1922,2006,1802,1884,2004,2122,2547,2667,2965,2629
Egypt,EG,EGY,Africa,2011,7411,2356,660,952,851,584,1474,1511,1244,1383,1403,1435,1905,1925,2095,1834
Egypt,EG,EGY,Africa,2010,6631,1562,516,669,494,306,1070,1010,822,914,916,800,1315,1317,1316,1161
Egypt,EG,EGY,Africa,2009,5166,1065,366,516,250,231,795,616,597,600,702,481,879,981,847,786
Eritrea,ER,ERI,Africa,2018,4,0,0,0,0,0,0,0,0,0,0,0,0,0,0,0
Eritrea,ER,ERI,Africa,2017,1,0,0,0,0,0,0,0,0,0,0,0,0,0,0,0
Eritrea,ER,ERI,Africa,2016,1,0,0,0,0,0,0,0,0,0,0,0,0,0,0,0
Eritrea,ER,ERI,Africa,2015,3,0,0,0,0,0,0,0,0,0,0,0,0,0,0,0
Eritrea,ER,ERI,Africa,2014,3,0,0,0,0,0,0,0,0,0,0,0,0,0,0,0
Eritrea,ER,ERI,Africa,2013,5,1,0,1,0,1,1,0,1,1,1,1,1,1,1,1
Eritrea,ER,ERI,Africa,2011,2,1,0,1,1,0,1,1,0,1,1,1,1,1,1,1
Eritrea,ER,ERI,Africa,2010,4,2,2,0,0,0,2,2,2,0,0,0,2,2,2,0
Eritrea,ER,ERI,Africa,2009,6,1,0,0,0,1,0,0,1,0,1,1,0,1,1,1
Ethiopia,ET,ETH,Africa,2019,456,273,4,198,242,22,200,246,26,258,211,264,260,213,268,271
Ethiopia,ET,ETH,Africa,2018,2546,1595,64,1118,1274,219,1164,1338,283,1424,1243,1493,1470,1289,1557,1549
Ethiopia,ET,ETH,Africa,2017,2232,1386,106,920,940,263,1001,1046,369,1144,1081,1203,1225,1162,1309,1305
Ethiopia,ET,ETH,Africa,2016,1727,1084,119,720,639,245,807,758,364,846,871,884,933,958,1003,997
Ethiopia,ET,ETH,Africa,2015,1547,990,139,638,589,194,754,728,333,748,764,783,864,880,922,874
Ethiopia,ET,ETH,Africa,2014,1500,960,179,632,539,162,777,718,341,706,741,701,851,886,880,815
Ethiopia,ET,ETH,Africa,2013,1129,620,111,431,348,94,520,459,205,472,490,442,561,579,553,531
Ethiopia,ET,ETH,Africa,2012,858,415,101,270,223,43,348,324,144,309,299,266,387,377,367,338
Ethiopia,ET,ETH,Africa,2011,762,360,139,206,150,31,318,289,170,230,224,181,342,336,320,248
Ethiopia,ET,ETH,Africa,2010,578,240,84,139,87,29,204,171,113,156,158,116,221,223,200,175
Ethiopia,ET,ETH,Africa,2009,486,172,58,93,53,31,137,111,89,104,117,84,148,161,142,128
Gabon,GA,GAB,Africa,2019,30,10,0,4,4,6,4,4,6,5,9,10,5,9,10,10
Gabon,GA,GAB,Africa,2018,135,53,5,41,24,19,43,29,24,43,49,43,45,51,48,51
Gabon,GA,GAB,Africa,2017,147,64,17,46,26,14,55,43,31,53,48,40,62,57,57,55
Gabon,GA,GAB,Africa,2016,107,60,18,44,26,8,56,44,26,46,46,34,58,58,52,48
Gabon,GA,GAB,Africa,2015,115,53,15,36,21,14,45,36,29,38,42,35,47,51,50,44
Gabon,GA,GAB,Africa,2014,100,52,17,32,20,11,45,37,28,32,39,31,45,52,48,39
Gabon,GA,GAB,Africa,2013,97,53,12,38,28,9,49,40,21,39,41,37,50,52,49,42
Gabon,GA,GAB,Africa,2012,95,40,14,25,13,8,34,27,22,26,30,21,35,39,35,31
Gabon,GA,GAB,Africa,2011,106,50,13,38,23,10,45,36,23,39,42,33,46,49,46,43
Gabon,GA,GAB,Africa,2010,80,42,11,35,20,4,41,31,15,35,36,24,41,42,35,36
Gabon,GA,GAB,Africa,2009,64,36,12,20,11,6,31,23,18,20,25,17,31,36,29,25
Gambia,GM,GMB,Africa,2019,3,1,0,0,1,0,0,1,0,1,0,1,1,0,1,1
Gambia,GM,GMB,Africa,2018,20,14,0,11,11,3,11,11,3,14,11,14,14,11,14,14
Gambia,GM,GMB,Africa,2017,12,7,1,6,4,2,6,5,3,6,7,6,6,7,7,7
Gambia,GM,GMB,Africa,2016,13,11,1,9,7,1,10,8,2,10,9,8,11,10,9,10
Gambia,GM,GMB,Africa,2015,5,2,1,2,1,0,2,2,1,2,2,1,2,2,2,2
Gambia,GM,GMB,Africa,2014,9,6,2,2,2,1,4,4,3,3,3,3,5,5,5,4
Gambia,GM,GMB,Africa,2013,20,9,2,7,4,3,7,6,5,7,9,7,7,9,9,9
Gambia,GM,GMB,Africa,2012,12,5,2,3,2,0,5,4,2,3,3,2,5,5,4,3
Gambia,GM,GMB,Africa,2011,13,6,5,2,1,0,5,6,5,3,2,1,6,5,6,3
Gambia,GM,GMB,Africa,2010,7,5,2,2,3,0,4,5,2,3,2,3,5,4,5,3
Gambia,GM,GMB,Africa,2009,3,3,1,3,1,0,3,2,1,3,3,1,3,3,2,3
Ghana,GH,GHA,Africa,2019,577,249,13,140,201,24,152,214,37,218,159,225,230,171,238,237
Ghana,GH,GHA,Africa,2018,3230,1458,117,865,1003,261,954,1120,378,1224,1010,1264,1313,1099,1381,1369
Ghana,GH,GHA,Africa,2017,2751,1436,217,822,782,309,981,999,526,1072,1027,1091,1231,1186,1308,1277
Ghana,GH,GHA,Africa,2016,2528,1436,246,829,727,335,1009,973,581,1034,1051,1062,1214,1231,1308,1256
Ghana,GH,GHA,Africa,2015,2084,1123,264,640,501,242,829,765,506,764,810,743,953,999,1007,934
Ghana,GH,GHA,Africa,2014,1888,967,273,488,376,226,696,649,499,588,659,602,796,867,875,759
Ghana,GH,GHA,Africa,2013,1556,738,236,330,257,184,514,493,420,406,478,441,590,662,677,554
Ghana,GH,GHA,Africa,2012,1247,521,168,246,194,109,379,362,277,300,334,303,433,467,471,388
Ghana,GH,GHA,Africa,2011,989,393,163,214,135,57,327,298,220,236,258,192,349,371,355,280
Ghana,GH,GHA,Africa,2010,843,340,157,185,90,47,291,247,204,205,214,137,311,320,294,234
Ghana,GH,GHA,Africa,2009,673,231,134,107,50,17,213,184,151,115,117,67,221,223,201,125
Guinea,GN,GIN,Africa,2017,2,2,0,2,2,0,2,2,0,2,2,2,2,2,2,2
Guinea,GN,GIN,Africa,2016,5,5,0,5,3,1,5,3,1,5,5,4,5,5,4,5
Guinea,GN,GIN,Africa,2015,4,4,2,2,1,1,3,3,3,3,2,2,4,3,4,3
Guinea,GN,GIN,Africa,2014,1,0,0,0,0,0,0,0,0,0,0,0,0,0,0,0
Guinea,GN,GIN,Africa,2011,2,0,0,0,0,0,0,0,0,0,0,0,0,0,0,0
Guinea-Bissau,GW,GNB,Africa,2019,7,3,0,2,3,0,2,3,0,3,2,3,3,2,3,3
Guinea-Bissau,GW,GNB,Africa,2018,43,17,1,17,13,2,17,14,3,17,17,15,17,17,16,17
Guinea-Bissau,GW,GNB,Africa,2017,36,26,4,21,16,6,23,20,10,24,21,22,26,23,26,24
Guinea-Bissau,GW,GNB,Africa,2016,40,27,8,25,12,3,27,20,11,25,25,15,27,27,23,25
Guinea-Bissau,GW,GNB,Africa,2015,31,20,8,13,8,3,17,16,11,16,13,11,20,17,19,16
Guinea-Bissau,GW,GNB,Africa,2014,35,28,7,18,15,5,24,22,12,21,19,20,27,25,27,22
Guinea-Bissau,GW,GNB,Africa,2013,18,11,1,10,7,2,10,8,3,10,11,9,10,11,10,11
Guinea-Bissau,GW,GNB,Africa,2012,19,13,3,11,9,1,13,12,4,11,11,10,13,13,13,11
Guinea-Bissau,GW,GNB,Africa,2011,25,17,6,13,9,0,17,15,6,13,13,9,17,17,15,13
Guinea-Bissau,GW,GNB,Africa,2010,12,10,4,7,3,3,10,7,7,7,7,6,10,10,10,7
Guinea-Bissau,GW,GNB,Africa,2009,18,7,4,3,3,0,7,7,4,3,3,3,7,7,7,3
Ivory Coast,CI,CIV,Africa,2019,51,29,7,9,14,6,15,21,13,17,15,20,23,21,27,23
Ivory Coast,CI,CIV,Africa,2018,322,162,38,71,85,34,104,123,72,104,96,119,137,129,157,129
Ivory Coast,CI,CIV,Africa,2017,307,184,70,58,53,46,123,123,116,77,100,99,142,165,169,119
Ivory Coast,CI,CIV,Africa,2016,280,161,69,51,46,35,113,115,104,69,81,81,131,143,150,99
Ivory Coast,CI,CIV,Africa,2015,211,111,20,52,47,35,67,67,55,66,82,82,81,97,102,96
Ivory Coast,CI,CIV,Africa,2014,186,95,14,57,51,18,68,65,32,71,70,69,82,81,83,84
Ivory Coast,CI,CIV,Africa,2013,133,64,18,39,31,6,51,49,24,47,44,37,59,56,55,52
Ivory Coast,CI,CIV,Africa,2012,112,55,6,41,34,10,45,40,16,43,49,44,47,53,50,51
Ivory Coast,CI,CIV,Africa,2011,89,50,10,29,21,9,38,31,19,33,37,30,42,46,40,41
Ivory Coast,CI,CIV,Africa,2010,88,50,19,28,13,7,41,32,26,30,35,20,43,48,39,37
Ivory Coast,CI,CIV,Africa,2009,66,26,4,15,10,7,18,14,11,17,21,17,20,24,21,23
Kenya,KE,KEN,Africa,2019,463,247,27,146,164,52,171,191,79,192,176,216,217,201,243,222
Kenya,KE,KEN,Africa,2018,2740,1495,144,931,899,372,1037,1043,516,1181,1139,1271,1287,1245,1415,1389
Kenya,KE,KEN,Africa,2017,2578,1624,232,1041,818,409,1209,1050,641,1233,1265,1227,1401,1433,1459,1457
Kenya,KE,KEN,Africa,2016,2484,1608,273,1050,683,418,1213,956,691,1189,1306,1101,1352,1469,1374,1445
Kenya,KE,KEN,Africa,2015,2197,1355,233,911,589,300,1059,822,533,1028,1090,889,1176,1238,1122,1207
Kenya,KE,KEN,Africa,2014,2117,1302,259,850,522,314,1021,781,573,937,1044,836,1108,1215,1095,1131
Kenya,KE,KEN,Africa,2013,1738,999,213,717,391,195,839,604,408,769,825,586,891,947,799,877
Kenya,KE,KEN,Africa,2012,1524,839,202,593,340,121,712,542,323,649,664,461,768,783,663,720
Kenya,KE,KEN,Africa,2011,1394,731,243,517,260,66,667,503,309,547,552,326,697,702,569,582
Kenya,KE,KEN,Africa,2010,1268,641,240,438,195,57,576,435,297,474,467,252,612,605,492,503
Kenya,KE,KEN,Africa,2009,1184,503,193,345,169,31,458,362,224,377,358,200,490,471,393,390
Lesotho,LS,LSO,Africa,2019,3,1,0,0,1,0,0,1,0,1,0,1,1,0,1,1
Lesotho,LS,LSO,Africa,2018,34,13,1,5,9,3,6,10,4,10,7,12,11,8,13,12
Lesotho,LS,LSO,Africa,2017,32,18,2,6,13,3,8,15,5,13,9,16,15,11,18,16
Lesotho,LS,LSO,Africa,2016,40,13,2,7,9,1,8,11,3,11,8,10,12,9,12,12
Lesotho,LS,LSO,Africa,2015,31,15,3,6,4,6,8,7,9,8,11,10,10,13,13,13
Lesotho,LS,LSO,Africa,2014,24,12,3,4,5,2,6,8,5,8,6,7,10,8,10,10
Lesotho,LS,LSO,Africa,2013,30,14,4,5,7,2,9,11,6,8,7,9,12,11,13,10
Lesotho,LS,LSO,Africa,2012,24,6,0,0,3,3,0,3,3,3,3,6,3,3,6,6
Lesotho,LS,LSO,Africa,2011,25,4,1,3,2,1,3,3,2,3,4,3,3,4,4,4
Lesotho,LS,LSO,Africa,2010,46,11,1,8,1,1,9,2,2,9,9,2,10,10,3,10
Lesotho,LS,LSO,Africa,2009,46,17,6,11,5,0,14,11,6,14,11,5,17,14,11,14
Liberia,LR,LBR,Africa,2019,3,2,0,0,1,1,0,1,1,1,1,2,1,1,2,2
Liberia,LR,LBR,Africa,2018,26,16,0,13,4,11,13,4,11,16,13,15,16,13,15,16
Liberia,LR,LBR,Africa,2017,17,9,2,6,5,0,7,7,2,8,6,5,9,7,7,8
Liberia,LR,LBR,Africa,2016,15,10,0,8,7,0,8,7,0,10,8,7,10,8,7,10
Liberia,LR,LBR,Africa,2015,7,4,1,3,3,0,3,4,1,4,3,3,4,3,4,4
Liberia,LR,LBR,Africa,2014,7,5,1,3,3,0,4,4,1,4,3,3,5,4,4,4
Liberia,LR,LBR,Africa,2013,7,4,2,2,1,0,4,3,2,2,2,1,4,4,3,2
Liberia,LR,LBR,Africa,2012,8,6,1,5,2,0,5,3,1,6,5,2,6,5,3,6
Liberia,LR,LBR,Africa,2011,5,2,2,1,0,0,2,2,2,1,1,0,2,2,2,1
Liberia,LR,LBR,Africa,2010,3,2,1,2,0,0,2,1,1,2,2,0,2,2,1,2
Liberia,LR,LBR,Africa,2009,4,4,0,2,4,0,2,4,0,4,2,4,4,2,4,4
Libya,LY,LBY,Africa,2019,20,5,0,3,4,1,3,4,1,4,4,5,4,4,5,5
Libya,LY,LBY,Africa,2018,153,48,2,30,31,11,30,33,13,40,38,42,40,38,44,48
Libya,LY,LBY,Africa,2017,164,80,7,32,45,19,37,52,26,60,47,64,65,52,71,75
Libya,LY,LBY,Africa,2016,158,91,24,40,41,21,58,65,45,59,54,62,77,72,86,73
Libya,LY,LBY,Africa,2015,116,53,15,28,21,10,40,36,25,33,36,31,45,48,46,41
Libya,LY,LBY,Africa,2014,127,59,13,28,27,14,39,40,27,37,39,41,48,50,54,48
Libya,LY,LBY,Africa,2013,107,55,12,21,21,20,32,33,32,29,36,41,40,47,53,44
Libya,LY,LBY,Africa,2012,81,35,4,25,21,6,29,25,10,26,30,27,30,34,31,31
Libya,LY,LBY,Africa,2011,41,17,5,8,8,2,12,13,7,12,9,10,16,13,15,13
Libya,LY,LBY,Africa,2010,80,31,4,22,21,5,24,25,9,25,26,26,27,28,30,29
Libya,LY,LBY,Africa,2009,39,16,5,6,6,3,10,11,8,9,9,9,13,13,14,12
Madagascar,MG,MDG,Africa,2019,14,4,0,3,4,0,3,4,0,4,3,4,4,3,4,4
Madagascar,MG,MDG,Africa,2018,73,41,8,30,24,5,37,32,13,32,32,29,39,39,37,34
Madagascar,MG,MDG,Africa,2017,77,48,6,39,31,5,43,37,11,43,40,36,47,44,42,44
Madagascar,MG,MDG,Africa,2016,50,35,12,24,16,3,29,28,15,28,26,19,33,31,31,30
Madagascar,MG,MDG,Africa,2015,67,42,10,30,24,5,37,34,15,31,34,29,38,41,39,35
Madagascar,MG,MDG,Africa,2014,38,27,4,16,11,8,19,15,12,19,21,19,22,24,23,24
Madagascar,MG,MDG,Africa,2013,38,22,9,12,7,2,18,16,11,14,14,9,20,20,18,16
Madagascar,MG,MDG,Africa,2012,27,13,9,6,3,1,13,12,10,6,6,4,13,13,13,6
Madagascar,MG,MDG,Africa,2011,33,12,3,11,6,1,11,9,4,12,11,7,12,11,10,12
Madagascar,MG,MDG,Africa,2010,27,6,1,5,1,1,5,2,2,5,6,2,5,6,3,6
Madagascar,MG,MDG,Africa,2009,38,11,5,7,2,1,10,7,6,8,7,3,11,10,8,8
Malawi,MW,MWI,Africa,2019,83,48,2,35,35,10,36,37,12,44,38,45,45,39,47,47
Malawi,MW,MWI,Africa,2018,453,274,14,232,197,49,240,211,63,256,242,246,264,250,260,266
Malawi,MW,MWI,Africa,2017,436,321,31,263,192,60,276,223,91,291,280,252,304,293,283,308
Malawi,MW,MWI,Africa,2016,372,275,36,231,135,57,241,171,93,249,247,192,259,257,228,265
Malawi,MW,MWI,Africa,2015,346,245,43,190,107,57,215,150,100,205,205,164,230,230,207,220
Malawi,MW,MWI,Africa,2014,313,203,38,154,83,51,173,121,89,159,179,134,178,198,172,184
Malawi,MW,MWI,Africa,2013,292,196,41,149,73,40,172,114,81,152,170,113,175,193,154,173
Malawi,MW,MWI,Africa,2012,268,151,38,121,65,16,138,103,54,125,130,81,142,147,119,134
Malawi,MW,MWI,Africa,2011,224,130,32,111,56,8,126,88,40,113,113,64,128,128,96,115
Malawi,MW,MWI,Africa,2010,216,129,34,109,60,3,124,94,37,113,110,63,128,125,97,114
Malawi,MW,MWI,Africa,2009,179,98,38,80,35,2,97,73,40,81,80,37,98,97,75,81
Mali,ML,MLI,Africa,2019,70,41,2,21,19,19,23,21,21,23,37,38,25,39,40,39
Mali,ML,MLI,Africa,2018,383,216,22,178,116,57,187,138,79,192,193,173,201,202,195,207
Mali,ML,MLI,Africa,2017,375,244,35,199,143,44,215,178,79,220,207,187,236,223,222,228
Mali,ML,MLI,Africa,2016,348,214,27,174,100,55,186,127,82,180,196,155,192,208,182,202
Mali,ML,MLI,Africa,2015,344,191,28,157,94,40,170,122,68,165,170,134,178,183,162,178
Mali,ML,MLI,Africa,2014,276,130,19,109,50,37,115,69,56,116,117,87,122,123,106,124
Mali,ML,MLI,Africa,2013,294,165,34,143,59,24,157,93,58,146,148,83,160,162,117,151
Mali,ML,MLI,Africa,2012,324,179,38,157,62,12,172,100,50,160,161,74,175,176,112,164
Mali,ML,MLI,Africa,2011,272,135,26,114,44,15,128,70,41,115,120,59,129,134,85,121
Mali,ML,MLI,Africa,2010,200,87,31,68,26,8,83,57,39,70,70,34,85,85,65,72
Mali,ML,MLI,Africa,2009,193,81,18,72,29,10,79,47,28,72,74,39,79,81,57,74
Mauritania,MR,MRT,Africa,2019,2,2,0,2,2,0,2,2,0,2,2,2,2,2,2,2
Mauritania,MR,MRT,Africa,2018,20,13,0,11,10,2,11,10,2,12,12,12,12,12,12,13
Mauritania,MR,MRT,Africa,2017,15,12,6,5,6,0,11,12,6,6,5,6,12,11,12,6
Mauritania,MR,MRT,Africa,2016,6,4,0,3,4,0,3,4,0,4,3,4,4,3,4,4
Mauritania,MR,MRT,Africa,2015,10,5,1,4,3,1,4,4,2,4,5,4,4,5,5,5
Mauritania,MR,MRT,Africa,2014,13,9,2,6,5,2,7,7,4,7,7,7,8,8,9,8
Mauritania,MR,MRT,Africa,2013,8,4,0,1,1,2,1,1,2,2,3,3,2,3,3,4
Mauritania,MR,MRT,Africa,2012,8,4,1,2,1,2,3,2,3,2,3,3,3,4,4,3
Mauritania,MR,MRT,Africa,2011,14,7,3,4,3,0,7,6,3,4,4,3,7,7,6,4
Mauritania,MR,MRT,Africa,2010,9,3,3,0,0,0,3,3,3,0,0,0,3,3,3,0
Mauritania,MR,MRT,Africa,2009,20,5,0,5,5,0,5,5,0,5,5,5,5,5,5,5
Mauritius,MU,MUS,Africa,2019,47,8,0,5,6,1,5,6,1,8,5,7,8,5,7,8
Mauritius,MU,MUS,Africa,2018,254,56,8,22,33,14,29,41,22,38,33,47,45,40,55,49
Mauritius,MU,MUS,Africa,2017,200,63,6,35,33,14,41,39,20,48,44,47,54,50,53,57
Mauritius,MU,MUS,Africa,2016,171,63,10,27,24,18,34,34,28,41,42,42,48,49,52,56
Mauritius,MU,MUS,Africa,2015,157,52,10,25,21,15,34,31,25,34,34,36,43,43,46,43
Mauritius,MU,MUS,Africa,2014,149,51,9,18,19,19,26,28,28,24,37,38,32,45,47,43
Mauritius,MU,MUS,Africa,2013,153,58,19,28,20,13,44,39,32,34,36,33,50,52,52,42
Mauritius,MU,MUS,Africa,2012,136,38,13,19,16,4,29,29,17,24,23,20,34,33,33,28
Mauritius,MU,MUS,Africa,2011,76,19,11,5,3,2,16,14,13,7,6,5,18,17,16,8
Mauritius,MU,MUS,Africa,2010,98,22,9,10,3,7,15,12,16,10,17,10,15,22,19,17
Mauritius,MU,MUS,Africa,2009,71,14,5,4,2,3,9,7,8,6,7,5,11,12,10,9
Morocco,MA,MAR,Africa,2019,405,166,11,51,91,57,62,102,68,107,99,148,118,110,159,155
Morocco,MA,MAR,Africa,2018,2167,936,63,444,563,252,492,626,315,709,623,815,757,671,878,888
Morocco,MA,MAR,Africa,2017,2138,1006,145,462,550,239,592,695,384,676,662,789,806,792,934,876
Morocco,MA,MAR,Africa,2016,1749,804,97,438,465,189,513,562,286,607,560,654,682,635,751,729
Morocco,MA,MAR,Africa,2015,1423,689,83,478,427,138,536,510,221,547,562,565,605,620,648,631
Morocco,MA,MAR,Africa,2014,1504,716,120,490,389,155,576,509,275,528,592,544,614,678,664,630
Morocco,MA,MAR,Africa,2013,1151,516,97,320,208,158,398,305,255,366,392,366,444,470,463,438
Morocco,MA,MAR,Africa,2012,1111,435,93,298,122,189,362,215,282,333,336,311,397,400,404,371
Morocco,MA,MAR,Africa,2011,865,322,63,240,115,115,277,178,178,262,263,230,299,300,293,285
Morocco,MA,MAR,Africa,2010,671,202,77,141,72,32,178,149,109,156,150,104,193,187,181,165
Morocco,MA,MAR,Africa,2009,584,102,29,58,34,18,81,63,47,72,65,52,95,88,81,79
Mozambique,MZ,MOZ,Africa,2019,210,102,20,24,47,28,44,67,48,57,49,75,77,69,95,82
Mozambique,MZ,MOZ,Africa,2018,1463,643,67,207,409,110,266,476,177,497,294,519,556,353,586,584
Mozambique,MZ,MOZ,Africa,2017,1221,636,104,238,329,143,319,433,247,454,339,472,535,420,576,555
Mozambique,MZ,MOZ,Africa,2016,1178,581,82,264,257,159,318,339,241,419,372,416,473,426,498,527
Mozambique,MZ,MOZ,Africa,2015,1083,526,71,174,247,139,233,318,210,345,296,386,404,355,457,467
Mozambique,MZ,MOZ,Africa,2014,850,360,59,147,147,102,188,206,161,237,229,249,278,270,308,319
Mozambique,MZ,MOZ,Africa,2013,699,259,49,119,88,81,153,137,130,162,182,169,196,216,218,225
Mozambique,MZ,MOZ,Africa,2012,668,212,65,83,71,45,131,136,110,127,120,116,175,168,181,164
Mozambique,MZ,MOZ,Africa,2011,687,197,59,87,62,41,129,121,100,122,120,103,164,162,162,155
Mozambique,MZ,MOZ,Africa,2010,706,166,51,85,51,32,117,102,83,112,107,83,144,139,134,134
Mozambique,MZ,MOZ,Africa,2009,646,150,69,68,32,21,113,101,90,92,81,53,137,126,122,105
Namibia,NA,NAM,Africa,2019,36,18,3,8,6,6,9,9,9,11,14,12,12,15,15,17
Namibia,NA,NAM,Africa,2018,195,95,23,60,38,19,75,61,42,69,71,57,84,86,80,80
Namibia,NA,NAM,Africa,2017,206,142,44,68,50,32,99,94,76,86,93,82,117,124,126,111
Namibia,NA,NAM,Africa,2016,207,128,43,60,42,23,90,85,66,77,81,65,107,111,108,98
Namibia,NA,NAM,Africa,2015,179,110,34,61,30,26,82,64,60,68,82,56,89,103,90,89
Namibia,NA,NAM,Africa,2014,177,112,37,69,39,17,86,76,54,81,83,56,98,100,93,95
Namibia,NA,NAM,Africa,2013,143,97,28,63,41,13,78,69,41,75,70,54,90,85,82,82
Namibia,NA,NAM,Africa,2012,98,54,21,39,19,4,44,40,25,46,42,23,51,47,44,49
Namibia,NA,NAM,Africa,2011,93,47,17,35,16,3,43,33,20,38,36,19,46,44,36,39
Namibia,NA,NAM,Africa,2010,57,30,15,21,7,2,26,22,17,23,23,9,28,28,24,25
Namibia,NA,NAM,Africa,2009,62,34,20,26,9,1,29,29,21,30,27,10,33,30,30,31
Niger,NE,NER,Africa,2019,9,5,4,0,1,0,4,5,4,1,0,1,5,4,5,1
Niger,NE,NER,Africa,2018,46,26,11,10,9,6,20,20,17,15,11,15,25,21,26,16
Niger,NE,NER,Africa,2017,36,18,4,7,8,4,11,12,8,10,11,12,14,15,16,14
Niger,NE,NER,Africa,2016,25,19,2,11,8,5,12,10,7,13,16,13,14,17,15,18
Niger,NE,NER,Africa,2015,20,14,4,7,1,6,10,5,10,8,10,7,11,13,11,11
Niger,NE,NER,Africa,2014,31,16,3,9,3,5,11,6,8,10,13,8,12,15,11,14
Niger,NE,NER,Africa,2013,27,14,5,9,6,1,14,11,6,9,9,7,14,14,12,9
Niger,NE,NER,Africa,2012,24,5,1,4,2,0,5,3,1,4,4,2,5,5,3,4
Niger,NE,NER,Africa,2011,16,10,1,8,5,1,8,6,2,9,9,6,9,9,7,10
Niger,NE,NER,Africa,2010,19,9,2,6,2,1,7,4,3,8,6,3,9,7,5,8
Niger,NE,NER,Africa,2009,13,8,2,7,3,1,8,5,3,7,7,4,8,8,6,7
Nigeria,NG,NGA,Africa,2019,1260,528,68,186,318,127,247,386,195,367,286,445,428,347,513,467
Nigeria,NG,NGA,Africa,2018,8217,3884,544,1702,2297,865,2146,2841,1409,2785,2357,3162,3229,2801,3706,3440
Nigeria,NG,NGA,Africa,2017,7444,3921,725,1591,1892,1003,2189,2617,1728,2562,2352,2895,3160,2950,3620,3323
Nigeria,NG,NGA,Africa,2016,7307,3959,833,1572,1703,1073,2280,2536,1906,2433,2390,2776,3141,3098,3609,3251
Nigeria,NG,NGA,Africa,2015,6195,3329,833,1356,1179,999,2059,2012,1832,1826,2156,2178,2529,2859,3011,2626
Nigeria,NG,NGA,Africa,2014,6237,3420,859,1388,1132,1061,2107,1991,1920,1844,2245,2193,2563,2964,3052,2701
Nigeria,NG,NGA,Africa,2013,5237,2784,771,1030,774,957,1656,1545,1728,1372,1817,1731,1998,2443,2502,2159
Nigeria,NG,NGA,Africa,2012,4271,2093,756,797,618,489,1425,1374,1245,1052,1210,1107,1680,1838,1863,1465
Nigeria,NG,NGA,Africa,2011,3770,1662,693,637,419,383,1218,1112,1076,785,933,802,1366,1514,1495,1081
Nigeria,NG,NGA,Africa,2010,3464,1487,663,643,393,281,1101,1056,944,811,861,674,1269,1319,1337,1029
Nigeria,NG,NGA,Africa,2009,2900,914,363,438,285,148,704,648,511,538,548,433,804,814,796,648
Republic of the Congo,CG,COG,Africa,2019,7,3,0,1,2,1,1,2,1,2,2,3,2,2,3,3
Republic of the Congo,CG,COG,Africa,2018,21,10,0,5,8,2,5,8,2,9,6,10,9,6,10,10
Republic of the Congo,CG,COG,Africa,2017,38,25,4,14,13,7,16,17,11,17,20,20,19,22,24,23
Republic of the Congo,CG,COG,Africa,2016,23,16,2,8,7,7,10,9,9,8,14,14,10,16,16,14
Republic of the Congo,CG,COG,Africa,2015,24,12,1,6,7,3,7,8,4,8,9,10,9,10,11,11
Republic of the Congo,CG,COG,Africa,2014,13,10,0,3,3,7,3,3,7,3,10,10,3,10,10,10
Republic of the Congo,CG,COG,Africa,2013,19,12,3,5,4,5,7,7,8,5,10,9,7,12,12,10
Republic of the Congo,CG,COG,Africa,2012,15,5,0,5,5,0,5,5,0,5,5,5,5,5,5,5
Republic of the Congo,CG,COG,Africa,2011,5,2,2,1,0,0,2,2,2,1,1,0,2,2,2,1
Republic of the Congo,CG,COG,Africa,2010,2,2,1,0,1,0,1,2,1,1,0,1,2,1,2,1
Republic of the Congo,CG,COG,Africa,2009,2,1,1,0,0,0,1,1,1,0,0,0,1,1,1,0
Reunion,RE,REU,Africa,2019,61,25,4,17,15,3,20,19,7,20,19,18,23,22,22,22
Reunion,RE,REU,Africa,2018,284,121,8,104,83,11,109,91,19,114,106,94,119,111,102,116
Reunion,RE,REU,Africa,2017,282,157,17,141,83,12,149,100,29,146,144,95,154,152,112,149
Reunion,RE,REU,Africa,2016,247,143,19,123,59,17,132,78,36,129,128,76,138,137,95,134
Reunion,RE,REU,Africa,2015,255,147,22,125,56,13,134,78,35,133,130,69,142,139,91,138
Reunion,RE,REU,Africa,2014,206,108,29,82,34,23,97,63,52,87,88,57,102,103,86,93
Reunion,RE,REU,Africa,2013,229,108,26,83,41,12,99,67,38,85,90,53,101,106,79,92
Reunion,RE,REU,Africa,2012,218,111,32,83,45,16,99,77,48,87,91,61,103,107,93,95
Reunion,RE,REU,Africa,2011,203,97,36,78,37,6,90,73,42,80,83,43,92,95,79,85
Reunion,RE,REU,Africa,2010,174,75,28,49,23,6,68,51,34,50,55,29,69,74,57,56
Reunion,RE,REU,Africa,2009,147,56,20,36,13,6,51,33,26,39,38,19,54,53,39,41
Senegal,SN,SEN,Africa,2019,96,45,10,19,18,17,26,28,27,24,33,35,31,40,45,38
Senegal,SN,SEN,Africa,2018,553,254,22,141,130,79,161,152,101,176,199,209,196,219,231,234
Senegal,SN,SEN,Africa,2017,659,410,47,185,162,162,224,209,209,229,327,324,268,366,371,371
Senegal,SN,SEN,Africa,2016,561,298,41,176,137,95,205,178,136,196,249,232,225,278,273,269
Senegal,SN,SEN,Africa,2015,509,302,48,170,123,106,194,171,154,195,253,229,219,277,277,278
Senegal,SN,SEN,Africa,2014,379,210,32,121,90,68,140,122,100,136,176,158,155,195,190,191
Senegal,SN,SEN,Africa,2013,391,183,36,105,88,37,129,124,73,128,136,125,152,160,161,159
Senegal,SN,SEN,Africa,2012,334,173,43,119,68,33,142,111,76,132,137,101,155,160,144,150
Senegal,SN,SEN,Africa,2011,277,120,42,74,44,16,102,86,58,82,84,60,110,112,102,92
Senegal,SN,SEN,Africa,2010,202,73,32,47,18,7,68,50,39,48,51,25,69,72,57,52
Senegal,SN,SEN,Africa,2009,188,69,22,49,28,5,62,50,27,53,52,33,66,65,55,56
Sierra Leone,SL,SLE,Africa,2019,4,2,0,2,1,1,2,1,1,2,2,2,2,2,2,2
Sierra Leone,SL,SLE,Africa,2018,57,44,7,33,29,6,38,36,13,39,33,35,44,38,42,39
Sierra Leone,SL,SLE,Africa,2017,72,54,8,42,26,16,48,34,24,45,45,42,51,51,50,48
Sierra Leone,SL,SLE,Africa,2016,69,53,11,35,30,9,43,41,20,43,37,39,51,45,50,45
Sierra Leone,SL,SLE,Africa,2015,49,26,5,22,9,7,25,14,12,22,23,16,25,26,21,23
Sierra Leone,SL,SLE,Africa,2014,27,15,5,12,6,0,15,11,5,12,12,6,15,15,11,12
Sierra Leone,SL,SLE,Africa,2013,21,10,4,7,2,2,8,6,6,7,9,4,8,10,8,9
Sierra Leone,SL,SLE,Africa,2012,17,5,2,3,3,0,5,5,2,3,3,3,5,5,5,3
Sierra Leone,SL,SLE,Africa,2011,15,7,4,4,3,0,7,7,4,4,4,3,7,7,7,4
Sierra Leone,SL,SLE,Africa,2010,17,9,3,4,5,0,7,8,3,6,4,5,9,7,8,6
Sierra Leone,SL,SLE,Africa,2009,26,6,0,3,4,1,3,4,1,5,4,5,5,4,5,6
Somalia,SO,SOM,Africa,2019,2,1,0,0,1,0,0,1,0,1,0,1,1,0,1,1
Somalia,SO,SOM,Africa,2018,3,1,0,1,0,1,1,0,1,1,1,1,1,1,1,1
Somalia,SO,SOM,Africa,2017,6,5,0,3,2,2,3,2,2,3,5,4,3,5,4,5
Somalia,SO,SOM,Africa,2016,1,0,0,0,0,0,0,0,0,0,0,0,0,0,0,0
Somalia,SO,SOM,Africa,2015,7,4,0,3,3,0,3,3,0,4,3,3,4,3,3,4
Somalia,SO,SOM,Africa,2014,3,0,0,0,0,0,0,0,0,0,0,0,0,0,0,0
Somalia,SO,SOM,Africa,2013,2,1,0,1,0,0,1,0,0,1,1,0,1,1,0,1
Somalia,SO,SOM,Africa,2012,1,0,0,0,0,0,0,0,0,0,0,0,0,0,0,0
South Africa,ZA,ZAF,Africa,2019,4372,1552,102,824,1077,259,903,1179,361,1313,985,1336,1392,1064,1438,1474
South Africa,ZA,ZAF,Africa,2018,23360,9615,793,5843,6271,1379,6333,7064,2172,8510,6459,7650,9000,6949,8443,9126
South Africa,ZA,ZAF,Africa,2017,24673,12287,1666,7553,6695,1923,8459,8361,3589,10404,8531,8618,11310,9437,10284,11382
South Africa,ZA,ZAF,Africa,2016,23275,12268,1837,7836,5726,2157,8724,7563,3994,10170,9046,7883,11058,9934,9720,11380
South Africa,ZA,ZAF,Africa,2015,20812,10975,1749,7184,5022,1847,8029,6771,3596,9061,8253,6869,9906,9098,8618,10130
South Africa,ZA,ZAF,Africa,2014,20599,11197,1972,6395,4808,2271,7322,6780,4243,8640,8026,7079,9567,8953,9051,10271
South Africa,ZA,ZAF,Africa,2013,18038,9588,2005,5832,3813,1613,6840,5818,3618,7574,6838,5426,8582,7846,7431,8580
South Africa,ZA,ZAF,Africa,2012,16137,8162,1834,5153,3468,1067,6061,5302,2901,6670,5737,4535,7578,6645,6369,7254
South Africa,ZA,ZAF,Africa,2011,14303,6646,1734,4259,2480,811,5124,4214,2545,5328,4712,3291,6193,5577,5025,5781
South Africa,ZA,ZAF,Africa,2010,12602,5419,1630,3351,1716,703,4203,3346,2333,4151,3768,2419,5003,4620,4049,4568
South Africa,ZA,ZAF,Africa,2009,11349,4627,1428,2893,1232,718,3616,2660,2146,3427,3371,1950,4150,4094,3378,3905
South Sudan,SS,SSD,Africa,2019,5,3,0,2,2,1,2,2,1,2,3,3,2,3,3,3
South Sudan,SS,SSD,Africa,2018,16,11,1,6,8,2,7,9,3,8,8,10,9,9,11,10
South Sudan,SS,SSD,Africa,2017,7,5,1,3,2,1,4,3,2,3,4,3,4,5,4,4
South Sudan,SS,SSD,Africa,2016,8,7,2,3,2,3,5,4,5,3,5,5,5,7,7,5
South Sudan,SS,SSD,Africa,2015,3,0,0,0,0,0,0,0,0,0,0,0,0,0,0,0
South Sudan,SS,SSD,Africa,2014,8,3,1,1,0,2,1,1,3,1,3,2,1,3,3,3
South Sudan,SS,SSD,Africa,2012,9,3,2,0,1,0,2,3,2,1,0,1,3,2,3,1
South Sudan,SS,SSD,Africa,2011,7,5,1,2,2,0,3,3,1,4,2,2,5,3,3,4
South Sudan,SS,SSD,Africa,2010,11,5,1,3,3,0,4,4,1,4,3,3,5,4,4,4
South Sudan,SS,SSD,Africa,2009,12,1,0,1,0,0,1,0,0,1,1,0,1,1,0,1
Sudan,SD,SDN,Africa,2019,92,46,1,18,33,11,19,34,12,35,28,44,36,29,45,45
Sudan,SD,SDN,Africa,2018,583,270,26,157,185,51,177,211,77,216,191,236,236,211,262,250
Sudan,SD,SDN,Africa,2017,641,358,56,170,170,103,217,226,159,232,249,273,279,296,329,311
Sudan,SD,SDN,Africa,2016,575,331,65,156,164,80,201,229,145,220,222,244,265,267,309,286
Sudan,SD,SDN,Africa,2015,494,249,46,129,114,66,164,160,112,161,182,180,196,217,226,214
Sudan,SD,SDN,Africa,2014,470,255,51,130,129,58,172,180,109,178,165,187,220,207,238,213
Sudan,SD,SDN,Africa,2013,387,188,44,109,88,40,142,132,84,128,136,128,161,169,172,155
Sudan,SD,SDN,Africa,2012,388,165,62,68,60,29,119,122,91,89,94,89,140,145,151,115
Sudan,SD,SDN,Africa,2011,294,142,39,92,73,16,119,112,55,105,102,89,132,129,128,115
Sudan,SD,SDN,Africa,2010,279,111,48,59,40,11,94,88,59,67,68,51,102,103,99,76
Sudan,SD,SDN,Africa,2009,233,67,29,41,23,6,59,52,35,46,44,29,64,62,58,49
Swaziland,SZ,SWZ,Africa,2019,5,1,0,0,1,0,0,1,0,1,0,1,1,0,1,1
Swaziland,SZ,SWZ,Africa,2018,45,18,5,8,8,3,13,13,8,11,10,11,16,15,16,13
Swaziland,SZ,SWZ,Africa,2017,38,16,7,8,5,2,14,12,9,10,8,7,16,14,14,10
Swaziland,SZ,SWZ,Africa,2016,44,23,2,12,8,9,14,10,11,14,19,17,16,21,19,21
Swaziland,SZ,SWZ,Africa,2015,35,12,5,3,5,2,8,10,7,5,5,7,10,10,12,7
Swaziland,SZ,SWZ,Africa,2014,32,16,7,5,2,6,10,9,13,6,10,8,11,15,15,11
Swaziland,SZ,SWZ,Africa,2013,31,17,7,7,5,3,13,12,10,10,8,8,16,14,15,11
Swaziland,SZ,SWZ,Africa,2012,33,14,4,4,5,3,8,9,7,7,7,8,11,11,12,10
Swaziland,SZ,SWZ,Africa,2011,33,4,1,1,2,1,2,3,2,2,2,3,3,3,4,3
Swaziland,SZ,SWZ,Africa,2010,43,12,3,4,6,1,7,9,4,8,5,7,11,8,10,9
Swaziland,SZ,SWZ,Africa,2009,30,9,1,8,2,0,9,3,1,8,8,2,9,9,3,8
Tanzania,TZ,TZA,Africa,2019,179,95,5,69,61,25,71,66,30,78,84,86,80,86,91,93
Tanzania,TZ,TZA,Africa,2018,997,593,41,437,418,113,464,459,154,520,483,531,547,510,572,566
Tanzania,TZ,TZA,Africa,2017,1047,690,115,519,366,142,580,481,257,569,579,508,630,640,623,629
Tanzania,TZ,TZA,Africa,2016,1043,691,83,511,353,170,552,436,253,569,592,523,610,633,606,650
Tanzania,TZ,TZA,Africa,2015,962,641,109,459,357,110,530,466,219,497,532,467,568,603,576,570
Tanzania,TZ,TZA,Africa,2014,957,645,136,451,324,114,514,460,250,506,527,438,569,590,574,582
Tanzania,TZ,TZA,Africa,2013,782,473,100,362,251,67,412,351,167,385,400,318,435,450,418,423
Tanzania,TZ,TZA,Africa,2012,709,431,110,321,231,42,376,341,152,354,343,273,409,398,383,376
Tanzania,TZ,TZA,Africa,2011,641,348,101,285,177,29,330,278,130,293,295,206,338,340,307,303
Tanzania,TZ,TZA,Africa,2010,563,302,92,234,142,26,270,234,118,249,251,168,285,287,260,266
Tanzania,TZ,TZA,Africa,2009,558,265,95,181,101,31,238,196,126,187,202,132,244,259,227,208
Togo,TG,TGO,Africa,2019,36,13,2,6,6,5,8,8,7,7,10,11,9,12,13,11
Togo,TG,TGO,Africa,2018,207,112,21,52,51,34,73,72,55,67,76,85,88,97,106,91
Togo,TG,TGO,Africa,2017,181,128,28,43,42,55,66,70,83,54,94,97,77,117,125,105
Togo,TG,TGO,Africa,2016,146,84,25,36,34,19,59,59,44,44,53,53,67,76,78,61
Togo,TG,TGO,Africa,2015,148,78,13,31,35,27,44,48,40,40,56,62,53,69,75,65
Togo,TG,TGO,Africa,2014,119,69,12,32,30,24,40,42,36,41,52,54,49,60,66,61
Togo,TG,TGO,Africa,2013,110,56,13,28,22,15,37,35,28,33,42,37,42,51,50,47
Togo,TG,TGO,Africa,2012,84,43,11,20,8,18,29,19,29,21,33,26,30,42,37,34
Togo,TG,TGO,Africa,2011,68,29,13,10,5,11,20,18,24,11,18,16,21,28,29,19
Togo,TG,TGO,Africa,2010,78,34,13,16,6,5,28,19,18,18,20,11,30,32,24,22
Togo,TG,TGO,Africa,2009,50,18,10,4,2,6,13,12,16,5,8,8,14,17,18,9
Tunisia,TN,TUN,Africa,2019,1049,195,17,70,142,22,86,159,39,159,90,164,175,106,181,179
Tunisia,TN,TUN,Africa,2018,6169,1180,122,632,634,244,734,756,366,891,819,878,993,921,1000,1078
Tunisia,TN,TUN,Africa,2017,6165,1503,233,730,686,347,921,919,580,1039,1003,1033,1230,1194,1266,1312
Tunisia,TN,TUN,Africa,2016,5715,1406,232,696,556,389,879,788,621,921,998,945,1104,1181,1177,1223
Tunisia,TN,TUN,Africa,2015,4851,1272,190,643,503,355,794,693,545,820,944,858,971,1095,1048,1121
Tunisia,TN,TUN,Africa,2014,4043,1110,228,519,388,336,689,616,564,651,808,724,821,978,952,940
Tunisia,TN,TUN,Africa,2013,3758,992,206,457,367,284,627,573,490,587,692,651,757,862,857,822
Tunisia,TN,TUN,Africa,2012,3258,864,269,371,259,244,573,528,513,465,568,503,667,770,772,662
Tunisia,TN,TUN,Africa,2011,2757,689,190,321,216,204,461,406,394,382,488,420,522,628,610,549
Tunisia,TN,TUN,Africa,2010,2224,443,154,225,115,100,335,269,254,256,302,215,366,412,369,333
Tunisia,TN,TUN,Africa,2009,1932,336,104,142,96,94,225,200,198,170,225,190,253,308,294,253
Uganda,UG,UGA,Africa,2019,302,176,9,117,139,22,122,148,31,157,131,161,162,136,170,171
Uganda,UG,UGA,Africa,2018,1731,1021,47,828,730,156,853,777,203,949,875,886,974,900,933,996
Uganda,UG,UGA,Africa,2017,1645,1166,138,940,670,201,1009,808,339,1024,1013,871,1093,1082,1009,1097
Uganda,UG,UGA,Africa,2016,1486,1092,151,901,573,169,962,724,320,976,956,742,1037,1017,893,1031
Uganda,UG,UGA,Africa,2015,1429,1039,143,861,586,161,927,729,304,913,921,747,979,987,890,973
Uganda,UG,UGA,Africa,2014,1304,950,127,782,464,143,835,591,270,825,854,607,878,907,734,897
Uganda,UG,UGA,Africa,2013,1128,770,145,605,363,111,679,508,256,643,658,474,717,732,619,696
Uganda,UG,UGA,Africa,2012,982,641,151,530,309,40,601,460,191,553,547,349,624,618,500,570
Uganda,UG,UGA,Africa,2011,881,553,131,449,254,47,520,385,178,465,466,301,536,537,432,482
Uganda,UG,UGA,Africa,2010,746,440,101,361,208,19,399,309,120,397,366,227,435,404,328,402
Uganda,UG,UGA,Africa,2009,643,328,87,271,131,19,314,218,106,281,275,150,324,318,237,285
Zambia,ZM,ZMB,Africa,2019,91,41,1,29,29,7,30,30,8,37,32,36,38,33,37,40
Zambia,ZM,ZMB,Africa,2018,483,280,22,201,177,65,216,199,87,231,235,242,246,250,264,265
Zambia,ZM,ZMB,Africa,2017,505,366,44,265,201,83,294,245,127,306,296,284,335,325,328,337
Zambia,ZM,ZMB,Africa,2016,442,300,42,245,144,59,268,186,101,255,267,203,278,290,245,277
Zambia,ZM,ZMB,Africa,2015,390,286,41,231,162,30,253,203,71,247,248,192,269,270,233,264
Zambia,ZM,ZMB,Africa,2014,339,252,46,188,124,36,206,170,82,207,215,160,225,233,206,234
Zambia,ZM,ZMB,Africa,2013,277,199,41,161,85,27,180,126,68,164,177,112,183,196,153,180
Zambia,ZM,ZMB,Africa,2012,292,177,35,126,97,12,146,132,47,149,134,109,169,154,144,157
Zambia,ZM,ZMB,Africa,2011,238,141,28,114,74,11,124,102,39,124,121,85,134,131,113,131
Zambia,ZM,ZMB,Africa,2010,202,125,32,97,61,7,113,93,39,109,97,68,125,113,100,109
Zambia,ZM,ZMB,Africa,2009,178,111,32,82,48,6,98,80,38,91,86,54,107,102,86,95
Zimbabwe,ZW,ZWE,Africa,2019,284,89,5,45,55,24,49,60,29,68,62,79,72,66,84,85
Zimbabwe,ZW,ZWE,Africa,2018,1711,564,48,350,342,122,387,390,170,468,409,464,505,446,512,527
Zimbabwe,ZW,ZWE,Africa,2017,1668,593,51,386,272,183,426,323,234,461,478,455,501,518,506,553
Zimbabwe,ZW,ZWE,Africa,2016,1380,498,58,307,186,147,349,244,205,360,403,333,402,445,391,456
Zimbabwe,ZW,ZWE,Africa,2015,1242,466,87,252,172,128,319,259,215,308,343,300,375,410,387,399
Zimbabwe,ZW,ZWE,Africa,2014,1055,395,98,201,128,103,285,226,201,241,271,231,325,355,329,311
Zimbabwe,ZW,ZWE,Africa,2013,852,300,89,134,98,63,216,187,152,173,179,161,255,261,250,218
Zimbabwe,ZW,ZWE,Africa,2012,683,229,59,121,80,53,162,139,112,148,161,133,189,202,192,188
Zimbabwe,ZW,ZWE,Africa,2011,533,177,43,91,75,21,121,118,64,134,104,96,164,134,139,147
Zimbabwe,ZW,ZWE,Africa,2010,364,115,32,78,39,9,100,71,41,88,83,48,110,105,80,93
Zimbabwe,ZW,ZWE,Africa,2009,290,61,16,37,18,9,46,34,25,45,44,27,54,53,43,52
Antigua and Barbuda,AG,ATG,Americas,2019,490,188,23,80,114,48,101,137,71,140,107,162,161,128,185,167
Antigua and Barbuda,AG,ATG,Americas,2018,2398,960,222,481,547,165,632,769,387,736,554,712,887,705,934,809
Antigua and Barbuda,AG,ATG,Americas,2017,1996,992,289,491,479,166,696,768,455,684,594,645,889,799,934,787
Antigua and Barbuda,AG,ATG,Americas,2016,1932,1043,301,538,474,172,754,775,473,726,639,646,942,855,947,827
Antigua and Barbuda,AG,ATG,Americas,2015,1678,888,235,487,427,152,644,662,387,648,570,579,805,727,814,731
Antigua and Barbuda,AG,ATG,Americas,2014,1448,687,198,381,297,107,507,495,305,497,445,404,623,571,602,561
Antigua and Barbuda,AG,ATG,Americas,2013,1276,660,201,284,255,152,430,456,353,392,406,407,538,552,608,514
Antigua and Barbuda,AG,ATG,Americas,2012,854,382,143,191,154,48,294,297,191,243,227,202,346,330,345,279
Antigua and Barbuda,AG,ATG,Americas,2011,674,278,99,130,101,49,216,200,148,161,161,150,247,247,249,192
Antigua and Barbuda,AG,ATG,Americas,2010,560,205,84,99,61,38,164,145,122,118,121,99,183,186,183,140
Antigua and Barbuda,AG,ATG,Americas,2009,431,139,65,58,41,16,113,106,81,74,68,57,129,123,122,84
Argentina,AR,ARG,Americas,2108,5,5,0,0,5,0,0,5,0,5,0,5,5,0,5,5
Argentina,AR,ARG,Americas,2099,1,1,0,0,1,0,0,1,0,1,0,1,1,0,1,1
Argentina,AR,ARG,Americas,2019,2140,727,45,422,484,102,456,529,147,633,482,586,667,516,631,693
Argentina,AR,ARG,Americas,2018,12290,5031,375,2673,3311,711,2932,3686,1086,4371,3074,4022,4630,3333,4397,4772
Argentina,AR,ARG,Americas,2017,12505,5918,949,3545,3145,898,4097,4094,1847,4865,4046,4043,5417,4598,4992,5366
Argentina,AR,ARG,Americas,2016,11282,5435,973,3032,2562,1037,3638,3535,2010,4210,3651,3599,4816,4257,4572,4829
Argentina,AR,ARG,Americas,2015,10545,5068,929,3007,2171,1115,3550,3100,2044,3874,3658,3286,4417,4201,4215,4525
Argentina,AR,ARG,Americas,2014,10027,4648,1033,2764,1962,806,3363,2995,1839,3577,3236,2768,4176,3835,3801,4049
Argentina,AR,ARG,Americas,2013,9503,4280,1003,2704,1596,832,3245,2599,1835,3271,3173,2428,3812,3714,3431,3740
Argentina,AR,ARG,Americas,2012,8862,3647,954,2066,1232,798,2640,2186,1752,2592,2547,2030,3166,3121,2984,3073
Argentina,AR,ARG,Americas,2011,8299,3161,1014,1720,928,624,2353,1942,1638,2136,2112,1552,2769,2745,2566,2528
Argentina,AR,ARG,Americas,2010,7582,2627,886,1455,721,411,1969,1607,1297,1838,1730,1132,2352,2244,2018,2113
Argentina,AR,ARG,Americas,2009,6873,2286,837,1271,532,382,1745,1369,1219,1548,1535,914,2022,2009,1751,1812
Aruba,AW,ABW,Americas,2019,1,0,0,0,0,0,0,0,0,0,0,0,0,0,0,0
Aruba,AW,ABW,Americas,2017,3,1,0,1,1,0,1,1,0,1,1,1,1,1,1,1
Aruba,AW,ABW,Americas,2016,1,0,0,0,0,0,0,0,0,0,0,0,0,0,0,0
Aruba,AW,ABW,Americas,2014,4,0,0,0,0,0,0,0,0,0,0,0,0,0,0,0
Aruba,AW,ABW,Americas,2011,1,0,0,0,0,0,0,0,0,0,0,0,0,0,0,0
Aruba,AW,ABW,Americas,2010,1,0,0,0,0,0,0,0,0,0,0,0,0,0,0,0
Bahamas,BS,BHS,Americas,2019,131,39,2,32,28,6,33,30,8,37,33,34,38,34,36,38
Bahamas,BS,BHS,Americas,2018,666,264,34,180,162,36,202,196,70,231,191,198,253,213,232,242
Bahamas,BS,BHS,Americas,2017,763,311,49,210,153,63,246,202,112,252,233,216,288,269,265,275
Bahamas,BS,BHS,Americas,2016,671,289,42,189,134,61,215,176,103,226,226,195,252,252,237,263
Bahamas,BS,BHS,Americas,2015,677,330,74,197,133,54,251,207,128,246,227,187,300,281,261,276
Bahamas,BS,BHS,Americas,2014,761,361,71,201,134,70,252,205,141,264,247,204,315,298,275,310
Bahamas,BS,BHS,Americas,2013,682,277,64,169,107,56,207,171,120,204,204,163,242,242,227,239
Bahamas,BS,BHS,Americas,2012,638,228,76,129,68,34,178,144,110,155,153,102,204,202,178,179
Bahamas,BS,BHS,Americas,2011,574,202,71,119,60,32,164,131,103,137,139,92,182,184,163,157
Bahamas,BS,BHS,Americas,2010,536,194,73,101,63,24,157,136,97,125,114,87,181,170,160,138
Bahamas,BS,BHS,Americas,2009,544,151,60,86,34,25,126,94,85,93,104,59,133,144,119,111
Belize,BZ,BLZ,Americas,2019,1,0,0,0,0,0,0,0,0,0,0,0,0,0,0,0
Belize,BZ,BLZ,Americas,2018,13,5,0,2,3,2,2,3,2,4,3,5,4,3,5,5
Belize,BZ,BLZ,Americas,2017,5,2,1,1,1,0,2,2,1,1,1,1,2,2,2,1
Belize,BZ,BLZ,Americas,2016,8,4,1,3,2,1,3,3,2,4,3,3,4,3,4,4
Belize,BZ,BLZ,Americas,2015,5,2,0,1,1,1,1,1,1,1,2,2,1,2,2,2
Belize,BZ,BLZ,Americas,2014,3,2,1,1,1,0,2,2,1,1,1,1,2,2,2,1
Belize,BZ,BLZ,Americas,2013,2,1,1,1,0,0,1,1,1,1,1,0,1,1,1,1
Belize,BZ,BLZ,Americas,2012,1,0,0,0,0,0,0,0,0,0,0,0,0,0,0,0
Belize,BZ,BLZ,Americas,2011,2,0,0,0,0,0,0,0,0,0,0,0,0,0,0,0
Belize,BZ,BLZ,Americas,2010,3,1,1,0,0,0,1,1,1,0,0,0,1,1,1,0
Belize,BZ,BLZ,Americas,2009,1,0,0,0,0,0,0,0,0,0,0,0,0,0,0,0
Bermuda,BM,BMU,Americas,2019,2,1,0,1,1,0,1,1,0,1,1,1,1,1,1,1
Bermuda,BM,BMU,Americas,2018,25,14,0,11,8,3,11,8,3,13,12,11,13,12,11,14
Bermuda,BM,BMU,Americas,2017,45,33,4,26,15,6,27,19,10,28,30,21,29,31,25,32
Bermuda,BM,BMU,Americas,2016,33,23,7,19,10,5,20,17,12,20,21,15,21,22,22,22
Bermuda,BM,BMU,Americas,2015,34,24,8,17,8,5,20,16,13,18,20,13,21,23,21,21
Bermuda,BM,BMU,Americas,2014,34,21,11,15,4,3,20,15,14,16,15,7,21,20,18,16
Bermuda,BM,BMU,Americas,2013,50,19,8,10,6,2,16,14,10,13,10,8,19,16,16,13
Bermuda,BM,BMU,Americas,2012,40,23,15,9,8,0,20,23,15,12,9,8,23,20,23,12
Bermuda,BM,BMU,Americas,2011,28,12,9,4,2,0,11,11,9,5,4,2,12,11,11,5
Bermuda,BM,BMU,Americas,2010,36,16,6,11,8,0,12,14,6,15,11,8,16,12,14,15
Bermuda,BM,BMU,Americas,2009,47,15,8,6,3,0,13,11,8,8,6,3,15,13,11,8
Bolivia,BO,BOL,Americas,2019,36,20,1,8,14,5,9,15,6,14,13,19,15,14,20,19
Bolivia,BO,BOL,Americas,2018,181,107,15,46,64,24,57,79,39,78,64,88,89,75,103,96
Bolivia,BO,BOL,Americas,2017,155,104,12,43,60,28,54,72,40,73,63,88,84,74,100,93
Bolivia,BO,BOL,Americas,2016,151,84,20,42,42,14,55,62,34,63,50,56,76,63,76,71
Bolivia,BO,BOL,Americas,2015,141,83,18,40,28,24,53,46,42,53,57,52,66,70,70,70
Bolivia,BO,BOL,Americas,2014,95,55,20,23,17,12,37,37,32,31,33,29,45,47,49,41
Bolivia,BO,BOL,Americas,2013,117,59,11,38,26,12,47,37,23,45,43,38,54,52,49,50
Bolivia,BO,BOL,Americas,2012,67,32,9,19,14,4,24,23,13,24,22,18,29,27,27,27
Bolivia,BO,BOL,Americas,2011,75,31,7,17,12,6,21,19,13,22,22,18,26,26,25,27
Bolivia,BO,BOL,Americas,2010,70,25,5,13,8,2,17,13,7,19,15,10,23,19,15,21
Bolivia,BO,BOL,Americas,2009,62,24,6,10,7,5,15,13,11,15,14,12,20,19,18,19
Brazil,BR,BRA,Americas,2108,1,1,0,0,1,0,0,1,0,1,0,1,1,0,1,1
Brazil,BR,BRA,Americas,2099,2,2,0,0,2,0,0,2,0,2,0,2,2,0,2,2
Brazil,BR,BRA,Americas,2022,2,0,0,0,0,0,0,0,0,0,0,0,0,0,0,0
Brazil,BR,BRA,Americas,2020,1,1,0,1,0,1,1,0,1,1,1,1,1,1,1,1
Brazil,BR,BRA,Americas,2019,15579,7037,556,2302,5363,771,2805,5919,1327,5950,2887,6134,6453,3390,6690,6535
Brazil,BR,BRA,Americas,2018,98171,53865,5332,15389,39757,6290,19983,45089,11622,44541,20121,46047,49135,24715,51379,49273
Brazil,BR,BRA,Americas,2017,100012,62445,10615,18293,39924,8369,27655,50539,18984,46406,24970,48293,55768,34332,58908,53083
Brazil,BR,BRA,Americas,2016,86875,55706,8815,17361,35346,8046,24731,44161,16861,42263,23434,43392,49633,30804,52207,48336
Brazil,BR,BRA,Americas,2015,78334,51281,7934,17166,32998,7294,23639,40932,15228,39142,22833,40292,45615,29306,48226,44809
Brazil,BR,BRA,Americas,2014,73783,47054,7285,17016,30157,6673,22827,37442,13958,36148,22113,36830,41959,27924,44115,41245
Brazil,BR,BRA,Americas,2013,66573,43065,6580,14764,27015,6774,19993,33595,13354,32711,19891,33789,37940,25120,40369,37838
Brazil,BR,BRA,Americas,2012,60988,39526,5972,12529,24982,6309,17203,30954,12281,30145,17236,31291,34819,21910,37263,34852
Brazil,BR,BRA,Americas,2011,53806,34336,5021,11052,21687,5590,14906,26708,10611,26296,15239,27277,30150,19093,32298,30483
Brazil,BR,BRA,Americas,2010,50060,30138,4650,9300,19516,4145,12759,24166,8795,23407,12573,23661,26866,16032,28311,26680
Brazil,BR,BRA,Americas,2009,45120,26541,4135,8406,17127,3515,11535,21262,7650,20725,11094,20642,23854,14223,24777,23413
British Virgin Islands,VG,VGB,Americas,2019,16,1,0,1,0,0,1,0,0,1,1,0,1,1,0,1
British Virgin Islands,VG,VGB,Americas,2018,82,14,5,5,3,1,10,8,6,8,6,4,13,11,9,9
British Virgin Islands,VG,VGB,Americas,2017,88,13,0,8,3,3,8,3,3,10,11,6,10,11,6,13
British Virgin Islands,VG,VGB,Americas,2016,81,10,1,7,1,3,8,2,4,7,9,4,8,10,5,9
British Virgin Islands,VG,VGB,Americas,2015,95,20,1,13,3,7,14,4,8,15,17,10,16,18,11,19
British Virgin Islands,VG,VGB,Americas,2014,72,7,1,5,0,2,5,1,3,5,7,2,5,7,3,7
British Virgin Islands,VG,VGB,Americas,2013,74,14,4,3,2,6,6,6,10,5,9,8,8,12,12,11
British Virgin Islands,VG,VGB,Americas,2012,72,10,6,4,1,2,8,7,8,4,6,3,8,10,9,6
British Virgin Islands,VG,VGB,Americas,2011,110,18,6,6,0,10,9,6,16,6,15,10,9,18,16,15
British Virgin Islands,VG,VGB,Americas,2010,82,15,8,6,0,1,14,8,9,6,7,1,14,15,9,7
British Virgin Islands,VG,VGB,Americas,2009,75,16,4,7,0,6,11,4,10,7,12,6,11,16,10,12
Canada,CA,CAN,Americas,2103,1,1,0,1,0,0,1,0,0,1,1,0,1,1,0,1
Canada,CA,CAN,Americas,2099,1,1,0,0,1,0,0,1,0,1,0,1,1,0,1,1
Canada,CA,CAN,Americas,2030,1,0,0,0,0,0,0,0,0,0,0,0,0,0,0,0
Canada,CA,CAN,Americas,2028,1,1,0,0,1,0,0,1,0,1,0,1,1,0,1,1
Canada,CA,CAN,Americas,2023,1,0,0,0,0,0,0,0,0,0,0,0,0,0,0,0
Canada,CA,CAN,Americas,2019,21484,6019,630,3707,3554,1081,4144,4184,1711,4908,4382,4635,5345,4819,5265,5583
Canada,CA,CAN,Americas,2018,103884,31707,4131,21979,17150,5179,24465,21281,9310,26946,24256,22329,29432,26742,26460,29223
Canada,CA,CAN,Americas,2017,105844,40002,10250,27666,14971,6119,33824,25221,16369,31002,30514,21090,37160,36672,31340,33850
Canada,CA,CAN,Americas,2016,98576,40418,10772,27272,13341,7043,33740,24113,17815,30274,30952,20384,36742,37420,31156,33954
Canada,CA,CAN,Americas,2015,93811,38594,11170,25798,12363,6621,32446,23533,17791,28332,29415,18984,34980,36063,30154,31949
Canada,CA,CAN,Americas,2014,91418,36479,11312,24236,11065,5936,30811,22377,17248,26461,27682,17001,33036,34257,28313,29907
Canada,CA,CAN,Americas,2013,89686,34372,11892,22162,9128,5616,29308,21020,17508,23970,25422,14744,31116,32568,26636,27230
Canada,CA,CAN,Americas,2012,84255,31189,11584,19695,7683,4812,26738,19267,16396,21523,22321,12495,28566,29364,24079,24149
Canada,CA,CAN,Americas,2011,80109,28202,11578,17269,5736,4039,24463,17314,15617,18747,19534,9775,25941,26728,21353,21012
Canada,CA,CAN,Americas,2010,76807,26543,11212,15557,5525,3142,22499,16737,14354,17806,17355,8667,24748,24297,19879,19604
Canada,CA,CAN,Americas,2009,73750,23485,10677,13873,3463,2952,20610,14140,13629,14974,15653,6415,21711,22390,17092,16754
Cayman Islands,KY,CYM,Americas,2018,16,7,1,6,5,0,7,6,1,6,6,5,7,7,6,6
Cayman Islands,KY,CYM,Americas,2017,4,0,0,0,0,0,0,0,0,0,0,0,0,0,0,0
Cayman Islands,KY,CYM,Americas,2016,10,3,1,1,1,0,2,2,1,2,1,1,3,2,2,2
Cayman Islands,KY,CYM,Americas,2015,7,2,1,1,1,0,2,2,1,1,1,1,2,2,2,1
Cayman Islands,KY,CYM,Americas,2014,4,2,1,0,0,1,1,1,2,0,1,1,1,2,2,1
Cayman Islands,KY,CYM,Americas,2013,4,2,1,1,0,0,2,1,1,1,1,0,2,2,1,1
Cayman Islands,KY,CYM,Americas,2012,12,5,1,3,1,2,3,2,3,3,5,3,3,5,4,5
Cayman Islands,KY,CYM,Americas,2011,12,4,1,3,2,1,3,3,2,3,4,3,3,4,4,4
Cayman Islands,KY,CYM,Americas,2010,12,3,1,0,0,2,1,1,3,0,2,2,1,3,3,2
Cayman Islands,KY,CYM,Americas,2009,12,6,1,3,2,3,3,3,4,5,4,5,5,4,6,6
Chile,CL,CHL,Americas,2108,1,1,0,0,1,0,0,1,0,1,0,1,1,0,1,1
Chile,CL,CHL,Americas,2099,2,1,0,0,1,0,0,1,0,1,0,1,1,0,1,1
Chile,CL,CHL,Americas,2027,1,0,0,0,0,0,0,0,0,0,0,0,0,0,0,0
Chile,CL,CHL,Americas,2019,1727,687,46,410,417,125,452,463,171,571,485,542,613,527,588,646
Chile,CL,CHL,Americas,2018,10318,5432,506,2753,2593,1445,3095,3099,1951,4008,3836,4038,4350,4178,4544,5091
Chile,CL,CHL,Americas,2017,10584,6171,958,3035,2604,1703,3448,3562,2661,4370,4423,4307,4783,4836,5265,5758
Chile,CL,CHL,Americas,2016,10254,6385,1175,2921,2326,1911,3531,3501,3086,4192,4504,4237,4802,5114,5412,5775
Chile,CL,CHL,Americas,2015,9193,5667,1135,2665,1922,1847,3205,3057,2982,3611,4181,3769,4151,4721,4904,5127
Chile,CL,CHL,Americas,2014,8127,5082,1607,2300,1611,1244,3252,3218,2851,3129,3301,2855,4081,4253,4462,4130
Chile,CL,CHL,Americas,2013,7369,4452,1017,1886,1240,1700,2372,2257,2717,2570,3282,2940,3056,3768,3957,3966
Chile,CL,CHL,Americas,2012,6854,4186,937,1677,1088,1724,2138,2025,2661,2331,3071,2812,2792,3532,3749,3725
Chile,CL,CHL,Americas,2011,6617,3990,922,1425,1098,1592,1902,2020,2514,2194,2744,2690,2671,3221,3612,3513
Chile,CL,CHL,Americas,2010,5701,3330,1010,1158,596,1318,1764,1606,2328,1589,2293,1914,2195,2899,2924,2724
Chile,CL,CHL,Americas,2009,5200,2873,736,993,519,1312,1380,1255,2048,1346,2133,1831,1733,2520,2567,2486
Colombia,CO,COL,Americas,2099,6,6,0,0,6,0,0,6,0,6,0,6,6,0,6,6
Colombia,CO,COL,Americas,2019,1658,765,38,320,563,129,346,601,167,647,412,692,673,438,730,739
Colombia,CO,COL,Americas,2018,10567,5757,509,2195,3855,1047,2620,4364,1556,4606,2921,4902,5031,3346,5411,5332
Colombia,CO,COL,Americas,2017,12049,7633,781,2592,4554,1815,3212,5335,2596,5564,4041,6369,6184,4661,7150,7013
Colombia,CO,COL,Americas,2016,11028,7293,868,2596,4280,1680,3280,5148,2548,5303,3902,5960,5987,4586,6828,6609
Colombia,CO,COL,Americas,2015,9532,6473,805,2204,3699,1535,2822,4504,2340,4652,3407,5234,5270,4025,6039,5855
Colombia,CO,COL,Americas,2014,7939,5212,769,1891,3057,1011,2512,3826,1780,3807,2675,4068,4428,3296,4837,4591
Colombia,CO,COL,Americas,2013,6576,3978,659,1425,2062,899,1934,2721,1558,2822,2072,2961,3331,2581,3620,3469
Colombia,CO,COL,Americas,2012,5394,3024,518,1182,1484,759,1530,2002,1277,2179,1679,2243,2527,2027,2761,2676
Colombia,CO,COL,Americas,2011,4691,2648,492,1075,1272,623,1395,1764,1115,1921,1483,1895,2241,1803,2387,2329
Colombia,CO,COL,Americas,2010,4024,2065,387,798,983,393,1040,1370,780,1508,1113,1376,1750,1355,1763,1823
Colombia,CO,COL,Americas,2009,3376,1663,392,650,668,319,910,1060,711,1137,916,987,1397,1176,1379,1403
Costa Rica,CR,CRI,Americas,2099,1,1,0,0,1,0,0,1,0,1,0,1,1,0,1,1
Costa Rica,CR,CRI,Americas,2019,148,65,1,28,57,6,29,58,7,62,30,63,63,31,64,64
Costa Rica,CR,CRI,Americas,2018,1100,648,68,225,471,77,277,539,145,556,265,548,608,317,616,596
Costa Rica,CR,CRI,Americas,2017,1102,742,81,228,480,135,290,561,216,582,326,615,644,388,696,680
Costa Rica,CR,CRI,Americas,2016,1131,821,69,306,567,123,350,636,192,699,384,690,743,428,759,777
Costa Rica,CR,CRI,Americas,2015,1226,929,82,287,668,116,344,750,198,802,357,784,859,414,866,872
Costa Rica,CR,CRI,Americas,2014,1065,739,113,300,508,69,390,621,182,602,347,577,692,437,690,649
Costa Rica,CR,CRI,Americas,2013,878,635,183,270,326,84,354,509,267,497,324,410,581,408,593,551
Costa Rica,CR,CRI,Americas,2012,687,465,87,228,236,89,267,323,176,403,251,325,442,290,412,426
Costa Rica,CR,CRI,Americas,2011,1426,1199,337,446,651,176,741,988,513,740,610,827,1035,905,1164,904
Costa Rica,CR,CRI,Americas,2010,462,267,67,109,143,21,152,210,88,211,122,164,254,165,231,224
Costa Rica,CR,CRI,Americas,2009,450,282,109,153,117,14,185,226,123,243,160,131,275,192,240,250
Cuba,CU,CUB,Americas,2019,124,61,4,27,50,6,31,54,10,54,30,56,58,34,60,57
Cuba,CU,CUB,Americas,2018,760,376,37,153,258,61,184,295,98,307,191,319,338,222,356,345
Cuba,CU,CUB,Americas,2017,811,469,59,223,276,93,262,335,152,373,280,369,412,319,428,430
Cuba,CU,CUB,Americas,2016,703,389,61,178,215,78,227,276,139,289,229,293,338,278,354,340
Cuba,CU,CUB,Americas,2015,636,340,49,166,187,57,201,236,106,263,208,244,298,243,293,305
Cuba,CU,CUB,Americas,2014,587,308,54,153,140,67,185,194,121,223,206,207,255,238,261,276
Cuba,CU,CUB,Americas,2013,537,279,63,151,119,56,189,182,119,202,190,175,240,228,238,241
Cuba,CU,CUB,Americas,2012,533,268,80,115,115,38,178,195,118,179,141,153,242,204,233,205
Cuba,CU,CUB,Americas,2011,556,264,86,120,102,34,194,188,120,169,141,136,243,215,222,190
Cuba,CU,CUB,Americas,2010,457,175,57,76,71,22,118,128,79,120,89,93,162,131,150,133
Cuba,CU,CUB,Americas,2009,438,161,47,69,58,27,105,105,74,100,94,85,136,130,132,125
Curacao,CW,CUW,Americas,2018,1,1,0,1,1,0,1,1,0,1,1,1,1,1,1,1
Curacao,CW,CUW,Americas,2013,2,1,0,1,0,0,1,0,0,1,1,0,1,1,0,1
Curacao,CW,CUW,Americas,2010,1,1,0,1,1,0,1,1,0,1,1,1,1,1,1,1
Curacao,CW,CUW,Americas,2009,1,0,0,0,0,0,0,0,0,0,0,0,0,0,0,0
Dominica,DM,DMA,Americas,2009,1,0,0,0,0,0,0,0,0,0,0,0,0,0,0,0
Dominican Republic,DO,DOM,Americas,2019,13,4,0,2,4,0,2,4,0,4,2,4,4,2,4,4
Dominican Republic,DO,DOM,Americas,2018,67,31,1,9,11,18,10,12,19,14,25,29,15,26,30,30
Dominican Republic,DO,DOM,Americas,2017,72,34,1,11,8,25,12,9,26,15,29,33,16,30,34,33
Dominican Republic,DO,DOM,Americas,2016,44,19,1,8,5,10,8,6,11,11,16,15,11,16,16,19
Dominican Republic,DO,DOM,Americas,2015,45,32,6,16,9,15,21,15,21,20,23,24,25,28,30,27
Dominican Republic,DO,DOM,Americas,2014,46,26,4,10,6,15,12,10,19,12,22,21,14,24,25,24
Dominican Republic,DO,DOM,Americas,2013,42,33,3,12,4,22,14,7,25,14,29,26,16,31,29,31
Dominican Republic,DO,DOM,Americas,2012,29,19,4,4,2,13,7,6,17,4,16,15,7,19,19,16
Dominican Republic,DO,DOM,Americas,2011,24,22,4,11,2,12,13,6,16,12,19,14,14,21,18,20
Dominican Republic,DO,DOM,Americas,2010,21,16,2,3,2,12,4,4,14,4,14,14,5,15,16,15
Dominican Republic,DO,DOM,Americas,2009,18,12,2,2,1,8,4,3,10,3,9,9,5,11,11,10
Ecuador,EC,ECU,Americas,2019,260,132,5,71,98,27,76,103,32,108,90,125,113,95,130,127
Ecuador,EC,ECU,Americas,2018,1476,838,119,372,543,143,472,662,262,649,461,686,749,561,805,738
Ecuador,EC,ECU,Americas,2017,1469,923,143,429,504,199,539,647,342,679,563,703,789,673,846,813
Ecuador,EC,ECU,Americas,2016,1089,670,99,327,360,144,401,459,243,500,423,504,574,497,603,596
Ecuador,EC,ECU,Americas,2015,784,487,56,234,272,94,272,328,150,384,299,366,422,337,422,449
Ecuador,EC,ECU,Americas,2014,568,356,42,204,209,45,224,251,87,313,227,254,333,247,296,336
Ecuador,EC,ECU,Americas,2013,455,263,36,149,134,39,167,170,75,221,173,173,239,191,209,245
Ecuador,EC,ECU,Americas,2012,385,226,25,135,116,55,147,141,80,204,145,171,216,157,196,214
Ecuador,EC,ECU,Americas,2011,344,200,25,130,61,79,149,86,104,163,148,140,182,167,165,181
Ecuador,EC,ECU,Americas,2010,323,179,23,83,78,37,97,101,60,138,110,115,152,124,138,165
Ecuador,EC,ECU,Americas,2009,251,151,31,88,54,12,105,85,43,131,91,66,148,108,97,134
El Salvador,SV,SLV,Americas,2019,39,18,3,6,15,0,9,18,3,15,6,15,18,9,18,15
El Salvador,SV,SLV,Americas,2018,169,89,9,19,71,8,26,80,17,77,24,79,84,31,88,82
El Salvador,SV,SLV,Americas,2017,297,235,25,30,94,113,54,119,138,108,133,207,132,157,232,211
El Salvador,SV,SLV,Americas,2016,164,129,24,24,73,31,47,97,55,77,53,104,100,76,128,106
El Salvador,SV,SLV,Americas,2015,151,117,27,23,69,17,46,96,44,79,38,86,102,61,113,94
El Salvador,SV,SLV,Americas,2014,162,137,26,38,95,14,60,121,40,105,48,109,127,70,135,115
El Salvador,SV,SLV,Americas,2013,151,112,17,20,79,16,36,96,33,83,33,95,99,49,112,96
El Salvador,SV,SLV,Americas,2012,235,206,5,35,183,15,40,188,20,190,46,198,195,51,203,201
El Salvador,SV,SLV,Americas,2011,244,203,19,20,177,5,35,196,24,184,24,182,199,39,201,188
El Salvador,SV,SLV,Americas,2010,181,139,16,22,106,15,35,122,31,112,36,121,125,49,137,126
El Salvador,SV,SLV,Americas,2009,124,96,8,24,77,10,29,85,18,82,33,87,87,38,95,91
French Guiana,GF,GUF,Americas,2019,3,3,0,3,3,0,3,3,0,3,3,3,3,3,3,3
French Guiana,GF,GUF,Americas,2018,34,11,0,11,11,0,11,11,0,11,11,11,11,11,11,11
French Guiana,GF,GUF,Americas,2017,32,17,4,15,9,0,17,13,4,15,15,9,17,17,13,15
French Guiana,GF,GUF,Americas,2016,24,12,3,10,5,0,12,8,3,10,10,5,12,12,8,10
French Guiana,GF,GUF,Americas,2015,13,5,1,4,4,0,5,5,1,4,4,4,5,5,5,4
French Guiana,GF,GUF,Americas,2014,22,16,5,15,6,1,16,11,6,15,15,7,16,16,12,15
French Guiana,GF,GUF,Americas,2013,13,10,3,10,6,0,10,9,3,10,10,6,10,10,9,10
French Guiana,GF,GUF,Americas,2012,12,7,2,4,1,1,6,3,3,4,5,2,6,7,4,5
French Guiana,GF,GUF,Americas,2011,14,6,2,5,2,1,5,4,3,5,6,3,5,6,5,6
French Guiana,GF,GUF,Americas,2010,7,1,1,1,0,0,1,1,1,1,1,0,1,1,1,1
French Guiana,GF,GUF,Americas,2009,11,2,1,2,1,0,2,2,1,2,2,1,2,2,2,2
Greenland,GL,GRL,Americas,2019,2,0,0,0,0,0,0,0,0,0,0,0,0,0,0,0
Greenland,GL,GRL,Americas,2018,24,14,2,10,9,2,12,11,4,12,10,11,14,12,13,12
Greenland,GL,GRL,Americas,2017,18,12,0,7,11,0,7,11,0,12,7,11,12,7,11,12
Greenland,GL,GRL,Americas,2016,16,10,1,7,6,1,8,7,2,9,7,7,10,8,8,9
Greenland,GL,GRL,Americas,2015,12,8,1,5,5,1,6,6,2,7,5,6,8,6,7,7
Greenland,GL,GRL,Americas,2014,18,7,2,2,2,3,4,4,5,2,5,5,4,7,7,5
Greenland,GL,GRL,Americas,2013,17,12,1,11,9,2,11,10,3,11,12,11,11,12,12,12
Greenland,GL,GRL,Americas,2012,7,4,0,4,4,0,4,4,0,4,4,4,4,4,4,4
Greenland,GL,GRL,Americas,2011,4,2,1,2,1,0,2,2,1,2,2,1,2,2,2,2
Greenland,GL,GRL,Americas,2010,6,3,1,1,2,0,1,3,1,3,1,2,3,1,3,3
Greenland,GL,GRL,Americas,2009,3,1,0,0,1,0,0,1,0,1,0,1,1,0,1,1
Grenada,GD,GRD,Americas,2019,95,35,10,21,19,4,30,29,14,24,23,23,33,32,33,26
Grenada,GD,GRD,Americas,2018,468,184,34,136,117,20,162,151,54,154,140,137,180,166,171,158
Grenada,GD,GRD,Americas,2017,450,179,48,121,87,29,158,135,77,134,129,116,171,166,164,142
Grenada,GD,GRD,Americas,2016,298,126,33,82,43,23,105,76,56,91,94,66,114,117,99,103
Grenada,GD,GRD,Americas,2015,239,102,23,60,27,27,78,50,50,68,76,54,86,94,77,84
Grenada,GD,GRD,Americas,2014,226,93,30,55,32,13,76,62,43,67,60,45,88,81,75,72
Grenada,GD,GRD,Americas,2013,185,61,19,35,15,16,51,34,35,37,43,31,53,59,50,45
Grenada,GD,GRD,Americas,2012,154,47,21,27,8,4,44,29,25,29,28,12,46,45,33,30
Grenada,GD,GRD,Americas,2011,153,37,17,21,10,4,34,27,21,23,22,14,36,35,31,24
Grenada,GD,GRD,Americas,2010,117,25,12,14,6,3,21,18,15,17,15,9,24,22,21,18
Grenada,GD,GRD,Americas,2009,101,15,11,5,1,1,13,12,12,6,6,2,14,14,13,7
Guadeloupe,GP,GLP,Americas,2019,1,0,0,0,0,0,0,0,0,0,0,0,0,0,0,0
Guadeloupe,GP,GLP,Americas,2018,1,1,0,1,0,1,1,0,1,1,1,1,1,1,1,1
Guadeloupe,GP,GLP,Americas,2017,5,3,0,1,2,1,1,2,1,2,2,3,2,2,3,3
Guadeloupe,GP,GLP,Americas,2016,2,2,1,1,0,0,2,1,1,1,1,0,2,2,1,1
Guadeloupe,GP,GLP,Americas,2015,5,3,0,0,1,2,0,1,2,1,2,3,1,2,3,3
Guadeloupe,GP,GLP,Americas,2014,5,2,1,0,1,0,1,2,1,1,0,1,2,1,2,1
Guadeloupe,GP,GLP,Americas,2013,3,1,0,0,1,0,0,1,0,1,0,1,1,0,1,1
Guadeloupe,GP,GLP,Americas,2012,3,2,0,1,0,1,1,0,1,1,2,1,1,2,1,2
Guadeloupe,GP,GLP,Americas,2011,5,3,2,0,1,0,2,3,2,1,0,1,3,2,3,1
Guadeloupe,GP,GLP,Americas,2010,8,7,6,0,1,0,6,7,6,1,0,1,7,6,7,1
Guadeloupe,GP,GLP,Americas,2009,1,0,0,0,0,0,0,0,0,0,0,0,0,0,0,0
Guatemala,GT,GTM,Americas,2099,1,1,0,0,1,0,0,1,0,1,0,1,1,0,1,1
Guatemala,GT,GTM,Americas,2019,68,32,3,23,25,3,26,28,6,28,24,28,31,27,31,29
Guatemala,GT,GTM,Americas,2018,398,227,18,151,162,33,164,180,51,202,163,195,215,176,213,214
Guatemala,GT,GTM,Americas,2017,378,248,23,170,160,41,186,183,64,214,188,201,230,204,224,232
Guatemala,GT,GTM,Americas,2016,346,242,23,168,149,48,183,172,71,209,186,197,224,201,220,227
Guatemala,GT,GTM,Americas,2015,264,195,26,138,111,44,153,137,70,169,149,155,184,164,181,180
Guatemala,GT,GTM,Americas,2014,207,155,13,126,82,27,133,95,40,142,132,109,149,139,122,148
Guatemala,GT,GTM,Americas,2013,200,134,22,100,25,59,114,47,81,112,108,84,126,122,106,120
Guatemala,GT,GTM,Americas,2012,204,156,20,133,27,92,143,47,112,139,140,119,149,150,139,146
Guatemala,GT,GTM,Americas,2011,156,103,23,75,16,54,92,39,77,80,81,70,97,98,93,86
Guatemala,GT,GTM,Americas,2010,93,54,9,42,11,7,46,20,16,47,45,18,51,49,27,50
Guatemala,GT,GTM,Americas,2009,86,49,12,38,13,5,40,25,17,44,41,18,46,43,30,47
Guyana,GY,GUY,Americas,2019,2,0,0,0,0,0,0,0,0,0,0,0,0,0,0,0
Guyana,GY,GUY,Americas,2018,30,11,1,6,6,3,7,7,4,10,6,9,11,7,10,10
Guyana,GY,GUY,Americas,2017,21,12,3,6,3,4,9,6,7,7,8,7,10,11,10,9
Guyana,GY,GUY,Americas,2016,14,7,3,4,2,1,6,5,4,4,5,3,6,7,6,5
Guyana,GY,GUY,Americas,2015,10,10,4,2,5,1,6,9,5,5,3,6,9,7,10,6
Guyana,GY,GUY,Americas,2014,13,4,2,0,0,2,2,2,4,0,2,2,2,4,4,2
Guyana,GY,GUY,Americas,2013,19,10,4,1,2,4,4,6,8,3,5,6,6,8,10,7
Guyana,GY,GUY,Americas,2012,10,6,1,1,1,3,2,2,4,2,4,4,3,5,5,5
Guyana,GY,GUY,Americas,2011,17,3,1,2,1,1,2,2,2,3,2,2,3,2,3,3
Guyana,GY,GUY,Americas,2010,11,5,2,2,1,1,4,3,3,3,2,2,5,4,4,3
Guyana,GY,GUY,Americas,2009,5,2,1,0,1,0,1,2,1,1,0,1,2,1,2,1
Jamaica,JM,JAM,Americas,2019,3,1,0,0,1,0,0,1,0,1,0,1,1,0,1,1
Jamaica,JM,JAM,Americas,2018,12,6,1,2,1,3,3,2,4,3,4,4,4,5,5,5
Jamaica,JM,JAM,Americas,2017,12,4,1,2,1,1,3,2,2,3,2,2,4,3,3,3
Jamaica,JM,JAM,Americas,2016,14,10,0,3,4,5,3,4,5,5,8,9,5,8,9,10
Jamaica,JM,JAM,Americas,2015,21,5,2,1,1,2,3,3,4,1,3,3,3,5,5,3
Jamaica,JM,JAM,Americas,2014,27,11,5,4,1,3,9,6,8,5,5,4,10,10,9,6
Jamaica,JM,JAM,Americas,2013,9,3,2,1,0,1,2,2,3,1,2,1,2,3,3,2
Jamaica,JM,JAM,Americas,2012,17,0,0,0,0,0,0,0,0,0,0,0,0,0,0,0
Jamaica,JM,JAM,Americas,2011,20,6,2,5,2,1,6,4,3,5,5,3,6,6,5,5
Jamaica,JM,JAM,Americas,2010,10,0,0,0,0,0,0,0,0,0,0,0,0,0,0,0
Jamaica,JM,JAM,Americas,2009,5,0,0,0,0,0,0,0,0,0,0,0,0,0,0,0
Mexico,MX,MEX,Americas,2099,16,15,0,0,15,0,0,15,0,15,0,15,15,0,15,15
Mexico,MX,MEX,Americas,2019,4466,1697,136,851,1091,328,968,1227,464,1360,1071,1419,1477,1188,1555,1580
Mexico,MX,MEX,Americas,2018,25285,10911,1104,5262,6434,2260,6117,7538,3364,8621,6697,8694,9476,7552,9798,10056
Mexico,MX,MEX,Americas,2017,25460,13126,1883,5811,6430,3342,7057,8313,5225,9352,8339,9772,10598,9585,11655,11880
Mexico,MX,MEX,Americas,2016,23321,12444,2082,5733,5376,3393,7124,7458,5475,8513,8274,8769,9904,9665,10851,11054
Mexico,MX,MEX,Americas,2015,20531,10868,1657,5093,4735,3152,6092,6392,4809,7446,7516,7887,8445,8515,9544,9869
Mexico,MX,MEX,Americas,2014,18892,9753,1850,4466,3923,2767,5582,5773,4617,6440,6663,6690,7556,7779,8540,8637
Mexico,MX,MEX,Americas,2013,16957,8183,1587,4046,3229,2185,4984,4816,3772,5647,5645,5414,6585,6583,7001,7246
Mexico,MX,MEX,Americas,2012,14902,6668,1738,3423,2334,1584,4462,4072,3322,4604,4448,3918,5643,5487,5656,5629
Mexico,MX,MEX,Americas,2011,12948,5184,1598,2703,1535,1149,3636,3133,2747,3450,3505,2684,4383,4438,4282,4252
Mexico,MX,MEX,Americas,2010,12001,4202,1529,2285,1042,714,3180,2571,2243,2797,2795,1756,3692,3690,3285,3307
Mexico,MX,MEX,Americas,2009,11382,4011,1407,2083,877,815,2894,2284,2222,2552,2731,1692,3363,3542,3099,3200
Montserrat,MS,MSR,Americas,2019,1,1,0,1,1,0,1,1,0,1,1,1,1,1,1,1
Montserrat,MS,MSR,Americas,2018,7,2,0,2,0,1,2,0,1,2,2,1,2,2,1,2
Montserrat,MS,MSR,Americas,2017,3,0,0,0,0,0,0,0,0,0,0,0,0,0,0,0
Montserrat,MS,MSR,Americas,2016,5,3,0,3,0,2,3,0,2,3,3,2,3,3,2,3
Montserrat,MS,MSR,Americas,2015,6,5,3,5,0,0,5,3,3,5,5,0,5,5,3,5
Montserrat,MS,MSR,Americas,2014,25,15,2,13,0,4,15,2,6,13,13,4,15,15,6,13
Montserrat,MS,MSR,Americas,2013,7,4,2,3,0,1,3,2,3,3,4,1,3,4,3,4
Montserrat,MS,MSR,Americas,2012,6,1,0,1,0,0,1,0,0,1,1,0,1,1,0,1
Montserrat,MS,MSR,Americas,2011,5,2,1,2,0,0,2,1,1,2,2,0,2,2,1,2
Montserrat,MS,MSR,Americas,2010,14,11,8,6,0,0,11,8,8,6,6,0,11,11,8,6
Montserrat,MS,MSR,Americas,2009,3,1,1,0,0,0,1,1,1,0,0,0,1,1,1,0
Nicaragua,NI,NIC,Americas,2019,5,3,0,3,3,0,3,3,0,3,3,3,3,3,3,3
Nicaragua,NI,NIC,Americas,2018,24,13,4,6,7,1,8,11,5,10,7,8,12,9,12,11
Nicaragua,NI,NIC,Americas,2017,16,12,3,8,7,1,10,10,4,10,8,8,12,10,11,10
Nicaragua,NI,NIC,Americas,2016,14,4,0,3,3,1,3,3,1,4,3,4,4,3,4,4
Nicaragua,NI,NIC,Americas,2015,8,6,2,5,1,1,5,3,3,5,6,2,5,6,4,6
Nicaragua,NI,NIC,Americas,2014,13,7,1,5,2,2,5,3,3,6,6,4,6,6,5,7
Nicaragua,NI,NIC,Americas,2013,7,7,3,7,2,1,7,5,4,7,7,3,7,7,6,7
Nicaragua,NI,NIC,Americas,2012,6,4,1,3,1,2,3,2,3,3,4,3,3,4,4,4
Nicaragua,NI,NIC,Americas,2011,20,9,6,4,0,1,9,6,7,4,4,1,9,9,7,4
Nicaragua,NI,NIC,Americas,2010,8,4,3,2,1,0,4,4,3,2,2,1,4,4,4,2
Nicaragua,NI,NIC,Americas,2009,8,3,3,1,0,0,3,3,3,1,1,0,3,3,3,1
Panama,PA,PAN,Americas,2019,113,51,6,32,30,11,36,36,17,41,38,41,45,42,47,47
Panama,PA,PAN,Americas,2018,552,304,66,188,133,80,242,199,146,218,220,213,272,274,279,250
Panama,PA,PAN,Americas,2017,509,283,58,188,128,61,223,186,119,213,223,189,248,258,247,248
Panama,PA,PAN,Americas,2016,424,246,45,165,114,46,186,159,91,191,199,160,212,220,205,225
Panama,PA,PAN,Americas,2015,425,250,75,167,107,30,208,182,105,191,185,137,232,226,212,209
Panama,PA,PAN,Americas,2014,342,168,35,126,92,16,145,127,51,146,129,108,165,148,143,149
Panama,PA,PAN,Americas,2013,371,167,52,102,82,14,133,134,66,129,109,96,160,140,148,136
Panama,PA,PAN,Americas,2012,377,153,48,95,76,11,122,124,59,122,99,87,149,126,135,126
Panama,PA,PAN,Americas,2011,329,128,54,71,48,5,107,102,59,89,74,53,125,110,107,92
Panama,PA,PAN,Americas,2010,341,118,55,68,36,12,100,91,67,79,75,48,111,107,103,86
Panama,PA,PAN,Americas,2009,260,99,51,46,26,11,76,77,62,62,53,37,92,83,88,69
Paraguay,PY,PRY,Americas,2019,31,16,0,8,12,3,8,12,3,15,9,15,15,9,15,16
Paraguay,PY,PRY,Americas,2018,272,187,7,35,129,50,41,136,57,138,78,179,144,84,186,181
Paraguay,PY,PRY,Americas,2017,245,185,10,40,139,27,48,149,37,157,60,166,165,68,176,177
Paraguay,PY,PRY,Americas,2016,255,195,12,26,137,41,35,149,53,147,65,178,156,74,190,186
Paraguay,PY,PRY,Americas,2015,203,148,14,31,110,17,43,124,31,123,44,127,135,56,141,136
Paraguay,PY,PRY,Americas,2014,89,55,9,19,38,6,26,47,15,44,23,44,51,30,53,48
Paraguay,PY,PRY,Americas,2013,74,40,9,11,21,10,19,30,19,23,20,31,31,28,40,32
Paraguay,PY,PRY,Americas,2012,77,27,4,10,12,10,13,16,14,18,16,22,21,19,26,24
Paraguay,PY,PRY,Americas,2011,60,28,5,14,14,4,18,19,9,20,18,18,24,22,23,24
Paraguay,PY,PRY,Americas,2010,42,22,6,12,8,5,15,14,11,15,16,13,18,19,19,19
Paraguay,PY,PRY,Americas,2009,33,14,3,4,7,4,6,10,7,8,8,11,10,10,14,12
Peru,PE,PER,Americas,2099,1,1,0,0,1,0,0,1,0,1,0,1,1,0,1,1
Peru,PE,PER,Americas,2019,359,205,8,89,128,63,95,136,71,153,135,191,159,141,199,199
Peru,PE,PER,Americas,2018,2284,1450,97,536,870,396,601,967,493,1107,814,1266,1172,879,1363,1385
Peru,PE,PER,Americas,2017,2514,1912,118,655,964,688,729,1082,806,1283,1210,1652,1357,1284,1770,1838
Peru,PE,PER,Americas,2016,2196,1697,143,595,752,658,689,895,801,1055,1143,1410,1149,1237,1553,1603
Peru,PE,PER,Americas,2015,1728,1320,137,534,561,491,606,698,628,845,937,1052,917,1009,1189,1248
Peru,PE,PER,Americas,2014,4589,4183,103,636,1744,2226,689,1847,2329,2097,2669,3970,2150,2722,4073,4130
Peru,PE,PER,Americas,2013,2080,1755,108,362,1299,266,423,1407,374,1480,576,1565,1541,637,1673,1694
Peru,PE,PER,Americas,2012,1296,1037,76,330,534,340,359,610,416,733,605,874,762,634,950,1008
Peru,PE,PER,Americas,2011,964,686,82,223,368,173,274,450,255,494,364,541,545,415,623,635
Peru,PE,PER,Americas,2010,627,389,72,163,184,79,196,256,151,294,225,263,327,258,335,356
Peru,PE,PER,Americas,2009,480,255,91,130,76,55,172,167,146,160,183,131,202,225,222,213
Saint Kitts and Nevis,KN,KNA,Americas,2019,66,32,1,20,25,6,21,26,7,26,25,31,27,26,32,31
Saint Kitts and Nevis,KN,KNA,Americas,2018,334,144,9,121,109,24,123,118,33,132,131,133,134,133,142,142
Saint Kitts and Nevis,KN,KNA,Americas,2017,268,141,23,100,82,22,121,105,45,109,111,104,130,132,127,120
Saint Kitts and Nevis,KN,KNA,Americas,2016,166,77,15,56,42,15,66,57,30,62,61,57,72,71,72,67
Saint Kitts and Nevis,KN,KNA,Americas,2015,107,71,9,49,47,10,56,56,19,58,55,57,65,62,66,64
Saint Kitts and Nevis,KN,KNA,Americas,2014,89,40,4,32,22,9,34,26,13,33,37,31,35,39,35,38
Saint Kitts and Nevis,KN,KNA,Americas,2013,49,18,2,13,8,4,14,10,6,14,16,12,15,17,14,17
Saint Kitts and Nevis,KN,KNA,Americas,2012,46,19,6,15,10,1,17,16,7,17,15,11,19,17,17,17
Saint Kitts and Nevis,KN,KNA,Americas,2011,22,7,2,5,3,1,5,5,3,6,6,4,6,6,6,7
Saint Kitts and Nevis,KN,KNA,Americas,2010,28,13,4,9,6,0,13,10,4,9,9,6,13,13,10,9
Saint Kitts and Nevis,KN,KNA,Americas,2009,23,12,1,10,9,0,11,10,1,11,10,9,12,11,10,11
Saint Lucia,LC,LCA,Americas,2018,10,6,3,3,3,0,5,6,3,4,3,3,6,5,6,4
Saint Lucia,LC,LCA,Americas,2017,3,2,1,0,0,1,1,1,2,0,1,1,1,2,2,1
Saint Lucia,LC,LCA,Americas,2016,4,1,1,0,0,0,1,1,1,0,0,0,1,1,1,0
Saint Lucia,LC,LCA,Americas,2015,8,7,1,2,3,3,3,4,4,3,5,6,4,6,7,6
Saint Lucia,LC,LCA,Americas,2014,4,2,0,2,2,0,2,2,0,2,2,2,2,2,2,2
Saint Lucia,LC,LCA,Americas,2013,2,1,0,1,1,0,1,1,0,1,1,1,1,1,1,1
Saint Lucia,LC,LCA,Americas,2012,1,0,0,0,0,0,0,0,0,0,0,0,0,0,0,0
Saint Lucia,LC,LCA,Americas,2011,1,0,0,0,0,0,0,0,0,0,0,0,0,0,0,0
Saint Lucia,LC,LCA,Americas,2009,1,1,1,1,0,0,1,1,1,1,1,0,1,1,1,1
Saint Vincent and the Grenadines,VC,VCT,Americas,2018,4,1,0,1,1,0,1,1,0,1,1,1,1,1,1,1
Saint Vincent and the Grenadines,VC,VCT,Americas,2017,7,5,2,0,1,2,2,3,4,1,2,3,3,4,5,3
Saint Vincent and the Grenadines,VC,VCT,Americas,2016,11,6,0,3,3,3,3,3,3,4,5,6,4,5,6,6
Saint Vincent and the Grenadines,VC,VCT,Americas,2015,2,1,0,1,0,0,1,0,0,1,1,0,1,1,0,1
Saint Vincent and the Grenadines,VC,VCT,Americas,2014,5,2,0,2,2,0,2,2,0,2,2,2,2,2,2,2
Saint Vincent and the Grenadines,VC,VCT,Americas,2013,2,0,0,0,0,0,0,0,0,0,0,0,0,0,0,0
Saint Vincent and the Grenadines,VC,VCT,Americas,2012,1,1,0,1,1,0,1,1,0,1,1,1,1,1,1,1
Saint Vincent and the Grenadines,VC,VCT,Americas,2011,3,3,1,1,0,2,2,1,3,1,2,2,2,3,3,2
Saint Vincent and the Grenadines,VC,VCT,Americas,2009,1,1,0,1,1,0,1,1,0,1,1,1,1,1,1,1
Sint Maarten,SX,SXM,Americas,2019,1,1,1,0,0,0,1,1,1,0,0,0,1,1,1,0
Sint Maarten,SX,SXM,Americas,2018,17,4,0,3,3,0,3,3,0,4,3,3,4,3,3,4
Sint Maarten,SX,SXM,Americas,2017,15,4,0,4,4,0,4,4,0,4,4,4,4,4,4,4
Sint Maarten,SX,SXM,Americas,2016,10,5,1,3,3,1,4,4,2,4,3,4,5,4,5,4
Sint Maarten,SX,SXM,Americas,2015,14,5,0,5,1,0,5,1,0,5,5,1,5,5,1,5
Sint Maarten,SX,SXM,Americas,2014,8,2,1,2,0,0,2,1,1,2,2,0,2,2,1,2
Sint Maarten,SX,SXM,Americas,2013,7,2,0,1,1,1,1,1,1,1,2,2,1,2,2,2
Sint Maarten,SX,SXM,Americas,2012,3,1,0,1,1,0,1,1,0,1,1,1,1,1,1,1
Sint Maarten,SX,SXM,Americas,2011,4,2,0,2,2,0,2,2,0,2,2,2,2,2,2,2
Sint Maarten,SX,SXM,Americas,2010,1,1,1,1,0,0,1,1,1,1,1,0,1,1,1,1
Sint Maarten,SX,SXM,Americas,2009,2,0,0,0,0,0,0,0,0,0,0,0,0,0,0,0
Suriname,SR,SUR,Americas,2019,6,1,0,0,1,0,0,1,0,1,0,1,1,0,1,1
Suriname,SR,SUR,Americas,2018,22,10,2,7,7,0,8,9,2,9,7,7,10,8,9,9
Suriname,SR,SUR,Americas,2017,39,16,5,12,6,1,15,11,6,12,13,7,15,16,12,13
Suriname,SR,SUR,Americas,2016,45,22,3,17,14,3,19,17,6,19,18,17,21,20,20,20
Suriname,SR,SUR,Americas,2015,26,14,0,10,10,2,10,10,2,13,11,12,13,11,12,14
Suriname,SR,SUR,Americas,2014,11,9,0,6,8,0,6,8,0,9,6,8,9,6,8,9
Suriname,SR,SUR,Americas,2013,18,8,3,6,4,0,8,7,3,6,6,4,8,8,7,6
Suriname,SR,SUR,Americas,2012,13,11,3,10,6,0,11,9,3,10,10,6,11,11,9,10
Suriname,SR,SUR,Americas,2011,7,3,1,2,1,1,3,2,2,2,2,2,3,3,3,2
Suriname,SR,SUR,Americas,2010,6,2,1,2,1,0,2,2,1,2,2,1,2,2,2,2
Suriname,SR,SUR,Americas,2009,3,2,0,1,1,0,1,1,0,2,1,1,2,1,1,2
Trinidad and Tobago,TT,TTO,Americas,2019,12,5,0,2,2,2,2,2,2,3,4,4,3,4,4,5
Trinidad and Tobago,TT,TTO,Americas,2018,39,20,3,13,10,6,15,13,9,18,13,16,20,15,19,18
Trinidad and Tobago,TT,TTO,Americas,2017,51,21,1,14,14,5,15,15,6,17,17,19,18,18,20,20
Trinidad and Tobago,TT,TTO,Americas,2016,34,21,8,12,5,4,17,13,12,13,15,9,18,20,17,16
Trinidad and Tobago,TT,TTO,Americas,2015,34,17,9,8,4,1,15,13,10,9,9,5,16,16,14,10
Trinidad and Tobago,TT,TTO,Americas,2014,48,27,10,8,2,13,15,12,23,9,19,15,16,26,25,20
Trinidad and Tobago,TT,TTO,Americas,2013,29,11,3,6,5,1,9,8,4,7,7,6,10,10,9,8
Trinidad and Tobago,TT,TTO,Americas,2012,18,3,2,1,1,0,3,3,2,1,1,1,3,3,3,1
Trinidad and Tobago,TT,TTO,Americas,2011,23,4,0,1,1,3,1,1,3,1,4,4,1,4,4,4
Trinidad and Tobago,TT,TTO,Americas,2010,32,5,3,2,1,1,4,4,4,2,3,2,4,5,5,3
Trinidad and Tobago,TT,TTO,Americas,2009,22,9,4,2,2,3,6,6,7,2,5,5,6,9,9,5
United States,US,USA,Americas,2108,2,2,0,2,2,0,2,2,0,2,2,2,2,2,2,2
United States,US,USA,Americas,2107,1,1,0,1,1,0,1,1,0,1,1,1,1,1,1,1
United States,US,USA,Americas,2104,1,0,0,0,0,0,0,0,0,0,0,0,0,0,0,0
United States,US,USA,Americas,2099,11,10,0,0,10,0,0,10,0,10,0,10,10,0,10,10
United States,US,USA,Americas,2047,1,1,1,0,0,0,1,1,1,0,0,0,1,1,1,0
United States,US,USA,Americas,2037,1,0,0,0,0,0,0,0,0,0,0,0,0,0,0,0
United States,US,USA,Americas,2036,1,1,0,1,0,0,1,0,0,1,1,0,1,1,0,1
United States,US,USA,Americas,2034,1,0,0,0,0,0,0,0,0,0,0,0,0,0,0,0
United States,US,USA,Americas,2027,1,0,0,0,0,0,0,0,0,0,0,0,0,0,0,0
United States,US,USA,Americas,2026,1,1,0,1,0,0,1,0,0,1,1,0,1,1,0,1
United States,US,USA,Americas,2025,1,0,0,0,0,0,0,0,0,0,0,0,0,0,0,0
United States,US,USA,Americas,2023,1,0,0,0,0,0,0,0,0,0,0,0,0,0,0,0
United States,US,USA,Americas,2020,3,3,2,2,0,1,2,2,3,2,3,1,2,3,3,3
United States,US,USA,Americas,2019,142150,35907,4768,22736,19858,6115,26574,24626,10883,28268,26548,25973,32106,30386,30741,32080
United States,US,USA,Americas,2018,687011,196938,27227,141920,103105,32678,158810,130332,59905,166197,155785,135783,183087,172675,163010,180062
United States,US,USA,Americas,2017,713445,269949,66592,192622,93621,46678,229196,160213,113270,212230,213785,140299,248804,250359,206891,233393
United States,US,USA,Americas,2016,668979,297739,69269,213423,82973,60535,248270,152242,129804,230866,245468,143508,265713,280315,212777,262911
United States,US,USA,Americas,2015,640742,289040,71895,210583,75662,55868,245377,147557,127763,224514,240329,131530,259308,275123,203425,254260
United States,US,USA,Americas,2014,628476,270935,74203,202634,63876,44396,237711,138079,118599,213860,224669,108272,248937,259746,182475,235895
United States,US,USA,Americas,2013,613387,258681,76200,193060,53792,38707,229374,129992,114907,202064,213378,92499,238378,249692,168699,222382
United States,US,USA,Americas,2012,582721,238892,75130,176770,44805,35260,212615,119935,110390,185138,194702,80065,220983,230547,155195,203070
United States,US,USA,Americas,2011,562963,222178,76755,161488,32972,31717,199188,109727,108472,167800,178180,64689,205500,215880,141444,184492
United States,US,USA,Americas,2010,544721,207699,72977,149048,29993,25721,183824,102970,98698,159522,162464,55714,194298,197240,128691,172938
United States,US,USA,Americas,2009,516240,187600,70939,137533,19085,22544,171452,90024,93483,142175,149052,41629,176094,182971,112568,153694
Uruguay,UY,URY,Americas,2019,115,37,4,26,24,3,29,28,7,32,28,27,35,31,31,34
Uruguay,UY,URY,Americas,2018,837,340,30,171,244,41,192,274,71,293,197,285,314,218,315,319
Uruguay,UY,URY,Americas,2017,770,342,58,161,175,68,211,233,126,249,204,243,299,254,301,292
Uruguay,UY,URY,Americas,2016,642,305,64,158,121,69,210,185,133,213,198,190,265,250,254,253
Uruguay,UY,URY,Americas,2015,585,250,41,147,102,53,175,143,94,186,183,155,214,211,196,222
Uruguay,UY,URY,Americas,2014,550,234,48,137,88,42,165,136,90,177,166,130,205,194,178,206
Uruguay,UY,URY,Americas,2013,485,189,39,122,63,46,140,102,85,141,152,109,159,170,148,171
Uruguay,UY,URY,Americas,2012,432,187,45,104,67,38,137,112,83,135,123,105,168,156,150,154
Uruguay,UY,URY,Americas,2011,397,143,28,77,48,31,101,76,59,103,93,79,127,117,107,119
Uruguay,UY,URY,Americas,2010,343,124,40,67,24,28,96,64,68,74,88,52,103,117,92,95
Uruguay,UY,URY,Americas,2009,300,115,25,73,20,23,92,45,48,81,88,43,100,107,68,96
Venezuela,VE,VEN,Americas,2019,171,74,6,26,55,12,31,61,18,59,36,67,64,41,73,69
Venezuela,VE,VEN,Americas,2018,1152,561,45,213,341,135,248,386,180,425,314,476,460,349,521,526
Venezuela,VE,VEN,Americas,2017,1306,681,78,271,392,151,333,470,229,500,390,543,562,452,621,619
Venezuela,VE,VEN,Americas,2016,1155,624,77,271,345,127,327,422,204,483,356,472,539,412,549,568
Venezuela,VE,VEN,Americas,2015,1075,554,83,225,292,125,279,375,208,402,323,417,456,377,500,500
Venezuela,VE,VEN,Americas,2014,979,521,86,243,260,103,298,346,189,386,323,363,441,378,449,466
Venezuela,VE,VEN,Americas,2013,1030,508,87,202,251,118,266,338,205,350,296,369,414,360,456,444
Venezuela,VE,VEN,Americas,2012,886,385,86,176,168,80,230,254,166,274,233,248,328,287,334,331
Venezuela,VE,VEN,Americas,2011,903,343,87,160,130,78,217,217,165,228,218,208,285,275,295,286
Venezuela,VE,VEN,Americas,2010,979,369,102,180,133,67,239,235,169,261,230,200,320,289,302,311
Venezuela,VE,VEN,Americas,2009,947,333,87,136,119,78,197,206,165,206,202,197,267,263,284,272
Afghanistan,AF,AFG,Asia,2019,5,4,2,1,1,1,3,3,3,1,2,2,3,4,4,2
Afghanistan,AF,AFG,Asia,2018,13,5,1,3,4,0,4,5,1,4,3,4,5,4,5,4
Afghanistan,AF,AFG,Asia,2017,15,9,3,5,4,2,6,7,5,6,7,6,7,8,9,8
Afghanistan,AF,AFG,Asia,2016,5,3,0,2,2,1,2,2,1,2,3,3,2,3,3,3
Afghanistan,AF,AFG,Asia,2015,1,0,0,0,0,0,0,0,0,0,0,0,0,0,0,0
Afghanistan,AF,AFG,Asia,2014,6,4,4,4,0,0,4,4,4,4,4,0,4,4,4,4
Afghanistan,AF,AFG,Asia,2013,4,3,2,2,1,0,2,3,2,3,2,1,3,2,3,3
Afghanistan,AF,AFG,Asia,2012,11,6,4,2,1,1,4,5,5,3,3,2,5,5,6,4
Afghanistan,AF,AFG,Asia,2011,3,0,0,0,0,0,0,0,0,0,0,0,0,0,0,0
Afghanistan,AF,AFG,Asia,2010,7,1,0,0,1,0,0,1,0,1,0,1,1,0,1,1
Afghanistan,AF,AFG,Asia,2009,11,2,0,0,0,2,0,0,2,0,2,2,0,2,2,2
Armenia,AM,ARM,Asia,2019,150,84,1,76,48,30,77,49,31,77,82,78,78,83,79,83
Armenia,AM,ARM,Asia,2018,763,473,12,427,271,137,433,283,149,452,442,408,458,448,420,467
Armenia,AM,ARM,Asia,2017,732,448,25,376,254,99,396,279,124,406,398,353,426,418,378,428
Armenia,AM,ARM,Asia,2016,679,426,18,356,235,121,372,253,139,382,384,356,398,400,374,410
Armenia,AM,ARM,Asia,2015,686,420,33,366,209,114,384,242,147,381,387,323,399,405,356,402
Armenia,AM,ARM,Asia,2014,691,393,37,324,159,108,344,196,145,332,365,267,352,385,304,373
Armenia,AM,ARM,Asia,2013,635,326,56,266,45,153,302,101,209,271,285,198,307,321,254,290
Armenia,AM,ARM,Asia,2012,663,379,69,315,18,226,358,87,295,319,332,244,362,375,313,336
Armenia,AM,ARM,Asia,2011,515,255,32,229,14,143,245,46,175,232,236,157,248,252,189,239
Armenia,AM,ARM,Asia,2010,521,183,54,150,13,53,167,67,107,152,164,66,169,181,120,166
Armenia,AM,ARM,Asia,2009,378,152,43,128,5,35,145,48,78,129,134,40,146,151,83,135
Azerbaijan,AZ,AZE,Asia,2019,82,32,3,23,21,7,25,24,10,30,23,28,32,25,31,30
Azerbaijan,AZ,AZE,Asia,2018,591,238,24,155,150,54,172,174,78,210,166,204,227,183,228,221
Azerbaijan,AZ,AZE,Asia,2017,495,196,25,104,103,48,129,128,73,138,137,151,163,162,176,171
Azerbaijan,AZ,AZE,Asia,2016,465,220,23,134,119,57,156,142,80,166,166,176,188,188,199,198
Azerbaijan,AZ,AZE,Asia,2015,423,199,27,128,109,50,153,136,77,156,146,159,181,171,186,174
Azerbaijan,AZ,AZE,Asia,2014,340,135,8,104,73,39,110,81,47,119,114,112,125,120,120,129
Azerbaijan,AZ,AZE,Asia,2013,333,109,11,79,24,56,89,35,67,91,87,80,101,97,91,99
Azerbaijan,AZ,AZE,Asia,2012,348,144,20,121,22,89,134,42,109,125,127,111,138,140,131,131
Azerbaijan,AZ,AZE,Asia,2011,325,101,6,77,36,48,83,42,54,83,89,84,89,95,90,95
Azerbaijan,AZ,AZE,Asia,2010,260,60,14,30,18,15,43,32,29,40,37,33,53,50,47,47
Azerbaijan,AZ,AZE,Asia,2009,233,35,6,18,15,4,23,21,10,28,20,19,33,25,25,30
Bahrain,BH,BHR,Asia,2019,68,25,0,12,22,3,12,22,3,24,13,25,24,13,25,25
Bahrain,BH,BHR,Asia,2018,384,135,22,68,80,27,82,102,49,109,80,107,123,94,129,121
Bahrain,BH,BHR,Asia,2017,332,155,24,83,78,43,103,102,67,109,109,121,129,129,145,135
Bahrain,BH,BHR,Asia,2016,316,135,26,72,64,36,88,90,62,98,93,100,114,109,126,119
Bahrain,BH,BHR,Asia,2015,259,111,34,57,28,27,84,62,61,65,76,55,92,103,89,84
Bahrain,BH,BHR,Asia,2014,262,106,32,54,27,28,74,59,60,65,75,55,85,95,87,86
Bahrain,BH,BHR,Asia,2013,252,92,26,45,29,24,66,55,50,52,64,53,73,85,79,71
Bahrain,BH,BHR,Asia,2012,173,56,25,24,15,12,44,40,37,26,34,27,46,54,52,36
Bahrain,BH,BHR,Asia,2011,177,68,29,30,9,15,54,38,44,31,43,24,55,67,53,44
Bahrain,BH,BHR,Asia,2010,159,34,10,18,8,7,25,18,17,21,24,15,28,31,25,27
Bahrain,BH,BHR,Asia,2009,148,49,18,31,17,4,44,35,22,33,34,21,46,47,39,36
Bangladesh,BD,BGD,Asia,2019,1004,396,61,162,227,95,218,288,156,281,221,322,337,277,383,340
Bangladesh,BD,BGD,Asia,2018,6027,3017,724,1052,1443,733,1690,2167,1457,1859,1573,2176,2497,2211,2900,2380
Bangladesh,BD,BGD,Asia,2017,5672,3550,1110,1136,1378,854,2147,2488,1964,1878,1797,2232,2889,2808,3342,2539
Bangladesh,BD,BGD,Asia,2016,5586,3763,1287,1121,1396,865,2301,2683,2152,1916,1788,2261,3096,2968,3548,2583
Bangladesh,BD,BGD,Asia,2015,4657,3039,1366,827,931,605,2062,2297,1971,1331,1300,1536,2566,2535,2902,1804
Bangladesh,BD,BGD,Asia,2014,4325,2790,1334,918,781,501,2099,2115,1835,1216,1311,1282,2397,2492,2616,1609
Bangladesh,BD,BGD,Asia,2013,4117,2615,1523,672,574,375,2035,2097,1898,950,974,949,2313,2337,2472,1252
Bangladesh,BD,BGD,Asia,2012,3662,2297,1410,590,535,239,1831,1945,1649,882,764,774,2123,2005,2184,1056
Bangladesh,BD,BGD,Asia,2011,2718,1616,910,466,413,178,1247,1323,1088,685,616,591,1466,1397,1501,835
Bangladesh,BD,BGD,Asia,2010,2510,1594,986,546,422,87,1332,1408,1073,741,613,509,1527,1399,1495,808
Bangladesh,BD,BGD,Asia,2009,2086,1238,844,521,231,87,1056,1075,931,649,575,318,1184,1110,1162,703
Bhutan,BT,BTN,Asia,2019,4,2,0,1,1,1,1,1,1,2,1,2,2,1,2,2
Bhutan,BT,BTN,Asia,2018,8,4,1,1,2,1,1,3,2,3,2,3,3,2,4,4
Bhutan,BT,BTN,Asia,2017,8,6,0,0,6,0,0,6,0,6,0,6,6,0,6,6
Bhutan,BT,BTN,Asia,2016,13,9,2,4,3,0,6,5,2,7,4,3,9,6,5,7
Bhutan,BT,BTN,Asia,2015,10,1,0,0,1,0,0,1,0,1,0,1,1,0,1,1
Bhutan,BT,BTN,Asia,2014,8,1,0,0,1,0,0,1,0,1,0,1,1,0,1,1
Bhutan,BT,BTN,Asia,2013,8,0,0,0,0,0,0,0,0,0,0,0,0,0,0,0
Bhutan,BT,BTN,Asia,2012,3,2,0,1,1,1,1,1,1,1,2,2,1,2,2,2
Bhutan,BT,BTN,Asia,2011,3,1,0,1,1,0,1,1,0,1,1,1,1,1,1,1
Brunei,BN,BRN,Asia,2019,46,17,1,9,10,6,9,11,7,13,13,16,13,13,17,17
Brunei,BN,BRN,Asia,2018,326,135,16,55,89,23,66,105,39,107,72,112,118,83,128,124
Brunei,BN,BRN,Asia,2017,309,139,14,70,68,34,80,82,48,103,96,102,113,106,116,129
Brunei,BN,BRN,Asia,2016,303,97,16,50,48,21,61,64,37,71,65,69,82,76,85,86
Brunei,BN,BRN,Asia,2015,291,110,22,46,43,35,62,65,57,70,70,78,86,86,100,94
Brunei,BN,BRN,Asia,2014,223,94,21,44,32,30,62,53,51,55,65,62,73,83,83,76
Brunei,BN,BRN,Asia,2013,166,66,25,32,18,11,49,43,36,39,42,29,56,59,54,49
Brunei,BN,BRN,Asia,2012,139,52,20,27,17,10,41,37,30,30,35,27,44,49,47,38
Brunei,BN,BRN,Asia,2011,99,26,10,16,7,4,24,17,14,16,18,11,24,26,21,18
Brunei,BN,BRN,Asia,2010,82,28,13,13,6,6,21,19,19,14,19,12,22,27,25,20
Brunei,BN,BRN,Asia,2009,82,16,5,8,4,3,12,9,8,9,11,7,13,15,12,12
Cambodia,KH,KHM,Asia,2019,243,91,11,51,62,14,60,73,25,72,61,76,81,70,87,82
Cambodia,KH,KHM,Asia,2018,1321,558,108,310,320,88,392,428,196,427,359,408,509,441,516,476
Cambodia,KH,KHM,Asia,2017,1241,605,193,315,285,89,473,478,282,388,374,374,546,532,567,447
Cambodia,KH,KHM,Asia,2016,1066,568,187,317,229,100,465,416,287,363,374,329,511,522,516,420
Cambodia,KH,KHM,Asia,2015,975,505,160,277,174,111,397,334,271,325,337,285,445,457,445,385
Cambodia,KH,KHM,Asia,2014,844,389,150,201,140,66,318,290,216,235,238,206,352,355,356,272
Cambodia,KH,KHM,Asia,2013,832,359,148,179,97,75,287,245,223,202,228,172,310,336,320,251
Cambodia,KH,KHM,Asia,2012,755,324,167,135,99,33,265,266,200,173,156,132,303,286,299,194
Cambodia,KH,KHM,Asia,2011,658,287,159,118,69,23,254,228,182,135,134,92,271,270,251,151
Cambodia,KH,KHM,Asia,2010,570,230,147,97,36,17,214,183,164,103,107,53,220,224,200,113
Cambodia,KH,KHM,Asia,2009,472,177,116,56,33,12,155,149,128,67,67,45,166,166,161,78
China,CN,CHN,Asia,2104,1,1,1,1,0,0,1,1,1,1,1,0,1,1,1,1
China,CN,CHN,Asia,2020,1,1,0,0,1,0,0,1,0,1,0,1,1,0,1,1
China,CN,CHN,Asia,2019,90161,22141,1354,12445,14914,3935,13567,16268,5289,18232,15233,18849,19354,16355,20203,21020
China,CN,CHN,Asia,2018,405194,106430,8585,65180,69557,18115,71178,78142,26700,89616,75999,87672,95614,81997,96257,100435
China,CN,CHN,Asia,2017,367856,113800,17580,70969,57562,23641,83575,75142,41221,88687,83484,81203,101293,96090,98783,101202
China,CN,CHN,Asia,2016,311060,95963,17374,63693,45624,18125,75638,62998,35499,74984,72732,63749,86929,84677,81123,84023
China,CN,CHN,Asia,2015,286217,83481,17225,53397,38368,15390,65132,55593,32615,63036,62110,53758,74771,73845,70983,71749
China,CN,CHN,Asia,2014,292287,69721,17233,42835,30521,10767,54247,47754,28000,51527,49623,41288,62939,61035,58521,58315
China,CN,CHN,Asia,2013,269616,59256,16868,34656,22923,9471,46089,39791,26339,41360,41120,32394,52793,52553,49262,47824
China,CN,CHN,Asia,2012,227460,50124,15893,26786,15464,10549,37671,31357,26442,31171,34855,26013,42056,45740,41906,39240
China,CN,CHN,Asia,2011,204827,38765,12798,20085,9278,9562,28904,22076,22360,22348,27684,18840,31167,36503,31638,29947
China,CN,CHN,Asia,2010,157330,28681,10822,16063,6386,4665,23484,17208,15487,17900,19424,11051,25321,26845,21873,21261
China,CN,CHN,Asia,2009,131107,25792,9921,13844,5066,4770,20738,14987,14691,15221,17522,9836,22115,24416,19757,18899
Cyprus,CY,CYP,Asia,2114,1,1,0,0,1,0,0,1,0,1,0,1,1,0,1,1
Cyprus,CY,CYP,Asia,2019,529,198,16,122,119,44,138,135,60,159,145,163,175,161,179,182
Cyprus,CY,CYP,Asia,2018,2464,880,71,646,500,169,690,571,240,775,707,669,819,751,740,836
Cyprus,CY,CYP,Asia,2017,2644,1116,121,704,457,295,784,578,416,847,893,752,927,973,873,1036
Cyprus,CY,CYP,Asia,2016,2133,933,125,609,316,283,689,441,408,686,776,599,766,856,724,853
Cyprus,CY,CYP,Asia,2015,1781,784,128,530,280,183,606,408,311,597,641,463,673,717,591,708
Cyprus,CY,CYP,Asia,2014,1577,591,85,379,223,147,440,308,232,436,473,370,497,534,455,530
Cyprus,CY,CYP,Asia,2013,1575,584,110,346,154,180,433,264,290,402,441,334,489,528,444,497
Cyprus,CY,CYP,Asia,2012,1430,514,79,352,100,207,408,179,286,384,426,307,440,482,386,458
Cyprus,CY,CYP,Asia,2011,1273,427,91,265,50,188,330,141,279,284,343,238,349,408,329,362
Cyprus,CY,CYP,Asia,2010,1128,387,79,249,68,102,286,147,181,277,322,170,314,359,249,350
Cyprus,CY,CYP,Asia,2009,978,313,56,202,36,83,235,92,139,218,265,119,251,298,175,281
Georgia,GE,GEO,Asia,2019,139,81,3,69,53,19,72,56,22,73,74,72,76,77,75,78
Georgia,GE,GEO,Asia,2018,748,461,22,371,278,112,384,300,134,424,395,390,437,408,412,448
Georgia,GE,GEO,Asia,2017,742,456,68,310,237,97,354,305,165,368,354,334,412,398,402,412
Georgia,GE,GEO,Asia,2016,693,466,46,346,244,113,370,290,159,403,385,357,427,409,403,442
Georgia,GE,GEO,Asia,2015,607,415,74,328,169,102,366,243,176,345,360,271,383,398,345,377
Georgia,GE,GEO,Asia,2014,538,320,55,256,133,80,280,188,135,268,284,213,292,308,268,296
Georgia,GE,GEO,Asia,2013,513,265,58,212,37,130,237,95,188,221,231,167,246,256,225,240
Georgia,GE,GEO,Asia,2012,500,293,58,248,26,161,272,84,219,260,257,187,284,281,245,269
Georgia,GE,GEO,Asia,2011,401,212,53,162,15,109,187,68,162,167,182,124,192,207,177,187
Georgia,GE,GEO,Asia,2010,370,178,79,129,27,26,155,106,105,145,136,53,171,162,132,152
Georgia,GE,GEO,Asia,2009,259,95,30,67,15,17,82,45,47,72,75,32,87,90,62,80
India,IN,IND,Asia,2099,1,1,0,0,0,1,0,0,1,0,1,1,0,1,1,1
India,IN,IND,Asia,2038,2,2,0,2,0,2,2,0,2,2,2,2,2,2,2,2
India,IN,IND,Asia,2019,20836,4783,759,1956,2732,778,2642,3491,1537,3533,2521,3510,4219,3207,4269,4098
India,IN,IND,Asia,2018,109911,29742,6213,12288,14032,6175,17819,20245,12388,19679,16821,20207,25210,22352,26420,24212
India,IN,IND,Asia,2017,112635,38958,10501,16559,14530,8746,25773,25031,19247,22685,23622,23276,31899,32836,33777,29748
India,IN,IND,Asia,2016,104559,40177,9182,18668,15082,9989,26344,24264,19171,24606,26564,25071,32282,34240,34253,32502
India,IN,IND,Asia,2015,90820,33214,6464,17127,13171,7774,22255,19635,14238,21903,23313,20945,27031,28441,27409,28089
India,IN,IND,Asia,2014,87837,31667,7686,16484,11967,6281,22332,19653,13967,21034,21271,18248,26882,27119,25934,25821
India,IN,IND,Asia,2013,76331,26188,6634,14832,9160,4899,19640,15794,11533,17867,18345,14059,22675,23153,20693,21380
India,IN,IND,Asia,2012,67285,22983,6264,13047,7434,4217,17546,13698,10481,15588,15945,11651,20087,20444,17915,18486
India,IN,IND,Asia,2011,57122,17400,4732,10648,5582,2662,14058,10314,7394,12330,12311,8244,15740,15721,12976,13993
India,IN,IND,Asia,2010,50306,13730,4372,8345,4263,1503,11204,8635,5875,9836,9382,5766,12695,12241,10138,10873
India,IN,IND,Asia,2009,42247,10229,3088,6372,3051,1121,8533,6139,4209,7339,7101,4172,9500,9262,7260,8068
Indonesia,ID,IDN,Asia,2020,1,1,1,0,0,0,1,1,1,0,0,0,1,1,1,0
Indonesia,ID,IDN,Asia,2019,3031,2013,124,426,1214,644,546,1338,768,1348,972,1858,1468,1092,1982,1894
Indonesia,ID,IDN,Asia,2018,23235,16755,930,3887,9931,5637,4661,10861,6567,11327,8541,15568,12101,9315,16498,15981
Indonesia,ID,IDN,Asia,2017,20130,16385,1265,2667,9007,5850,3789,10272,7115,10188,7742,14857,11310,8864,16122,15263
Indonesia,ID,IDN,Asia,2016,14919,12133,1017,2174,7626,3258,3043,8643,4275,8465,4973,10884,9334,5842,11901,11264
Indonesia,ID,IDN,Asia,2015,10405,7795,983,1406,4341,2238,2245,5324,3221,4943,3419,6579,5782,4258,7562,6956
Indonesia,ID,IDN,Asia,2014,7090,5104,654,1086,2969,1267,1640,3623,1921,3457,2179,4236,4011,2733,4890,4550
Indonesia,ID,IDN,Asia,2013,5895,4164,555,884,2384,1044,1336,2939,1599,2827,1769,3428,3279,2221,3983,3712
Indonesia,ID,IDN,Asia,2012,4412,3116,394,690,1849,753,1006,2243,1147,2175,1315,2602,2491,1631,2996,2800
Indonesia,ID,IDN,Asia,2011,3348,2273,263,502,1381,516,705,1644,779,1663,909,1897,1866,1112,2160,2070
Indonesia,ID,IDN,Asia,2010,3056,2155,253,759,1375,422,935,1628,675,1614,1124,1797,1790,1300,2050,1979
Indonesia,ID,IDN,Asia,2009,1929,1148,248,290,597,205,478,845,453,784,466,802,972,654,1050,960
Iran,IR,IRN,Asia,2038,1,1,0,1,0,1,1,0,1,1,1,1,1,1,1,1
Iran,IR,IRN,Asia,2019,10298,1995,191,791,1333,347,938,1524,538,1592,1047,1680,1739,1194,1871,1848
Iran,IR,IRN,Asia,2018,49759,12882,1809,5475,7827,2198,6921,9636,4007,9839,7073,10025,11285,8519,11834,11437
Iran,IR,IRN,Asia,2017,49670,14857,2732,6458,7596,2950,8689,10328,5682,10377,8707,10546,12608,10938,13278,12626
Iran,IR,IRN,Asia,2016,44241,15134,2758,6960,7050,3158,9232,9808,5916,10635,9187,10208,12907,11459,12966,12862
Iran,IR,IRN,Asia,2015,36909,12596,2388,6132,5191,3268,7998,7579,5656,8823,8039,8459,10689,9905,10847,10730
Iran,IR,IRN,Asia,2014,34324,11210,2287,5340,4375,3084,7120,6662,5371,7700,7070,7459,9480,8850,9746,9430
Iran,IR,IRN,Asia,2013,31168,9527,2171,4041,3310,2712,5805,5481,4883,5987,5817,6022,7751,7581,8193,7763
Iran,IR,IRN,Asia,2012,27843,8743,2557,3425,2699,2382,5604,5256,4939,4866,5123,5081,7045,7302,7638,6564
Iran,IR,IRN,Asia,2011,23705,6355,1906,2148,1613,2084,3820,3519,3990,2902,3929,3697,4574,5601,5603,4683
Iran,IR,IRN,Asia,2010,16869,3995,1457,1513,1001,923,2734,2458,2380,1983,2304,1924,3204,3525,3381,2774
Iran,IR,IRN,Asia,2009,13913,3009,1201,1225,693,627,2245,1894,1828,1511,1703,1320,2531,2723,2521,1989
Iraq,IQ,IRQ,Asia,2019,576,196,18,57,93,78,71,111,96,117,122,171,131,136,189,182
Iraq,IQ,IRQ,Asia,2018,3295,1432,134,477,774,450,598,908,584,942,846,1224,1063,967,1358,1311
Iraq,IQ,IRQ,Asia,2017,2519,1158,141,398,470,423,525,611,564,687,742,893,814,869,1034,1031
Iraq,IQ,IRQ,Asia,2016,1833,851,153,324,344,259,451,497,412,533,515,603,660,642,756,724
Iraq,IQ,IRQ,Asia,2015,1500,671,117,291,268,211,385,385,328,408,460,479,502,554,596,577
Iraq,IQ,IRQ,Asia,2014,1307,584,149,264,216,158,378,365,307,350,384,374,464,498,523,470
Iraq,IQ,IRQ,Asia,2013,1177,470,122,207,162,126,292,284,248,279,313,288,364,398,410,385
Iraq,IQ,IRQ,Asia,2012,842,376,107,152,124,97,244,231,204,215,221,221,307,313,328,284
Iraq,IQ,IRQ,Asia,2011,567,198,57,71,54,60,123,111,117,99,118,114,151,170,171,146
Iraq,IQ,IRQ,Asia,2010,407,123,27,52,40,34,77,67,61,73,77,74,98,102,101,98
Iraq,IQ,IRQ,Asia,2009,335,88,24,37,29,18,53,53,42,57,52,47,73,68,71,72
Israel,IL,ISR,Asia,2103,1,1,0,1,0,0,1,0,0,1,1,0,1,1,0,1
Israel,IL,ISR,Asia,2099,2,2,0,0,2,0,0,2,0,2,0,2,2,0,2,2
Israel,IL,ISR,Asia,2019,4672,1295,110,937,706,180,1017,816,290,1129,1024,886,1209,1104,996,1216
Israel,IL,ISR,Asia,2018,21678,6986,760,5403,3349,1079,5890,4109,1839,6103,5799,4428,6590,6286,5188,6499
Israel,IL,ISR,Asia,2017,22720,8719,1994,6329,3057,1455,7542,5051,3449,6910,6926,4512,8123,8139,6506,7507
Israel,IL,ISR,Asia,2016,21361,8679,1990,6310,2651,1679,7458,4641,3669,6766,7075,4330,7914,8223,6320,7531
Israel,IL,ISR,Asia,2015,20293,8177,2079,5790,2475,1544,6987,4554,3623,6202,6569,4019,7399,7766,6098,6981
Israel,IL,ISR,Asia,2014,19863,7568,2188,5236,2063,1277,6560,4251,3465,5560,5923,3340,6884,7247,5528,6247
Israel,IL,ISR,Asia,2013,19557,7246,2269,4917,1615,1348,6268,3884,3617,5197,5616,2963,6548,6967,5232,5896
Israel,IL,ISR,Asia,2012,18457,6694,2355,4463,1257,1277,5847,3612,3632,4704,5070,2534,6088,6454,4889,5311
Israel,IL,ISR,Asia,2011,17911,6253,2312,4098,976,1204,5473,3288,3516,4299,4679,2180,5674,6054,4492,4880
Israel,IL,ISR,Asia,2010,17445,5694,2199,3622,867,866,4918,3066,3065,3931,4089,1733,5227,5385,3932,4398
Israel,IL,ISR,Asia,2009,17776,5218,2227,3346,597,749,4678,2824,2976,3504,3728,1346,4836,5060,3573,3886
Japan,JP,JPN,Asia,2104,1,1,1,1,0,0,1,1,1,1,1,0,1,1,1,1
Japan,JP,JPN,Asia,2020,1,1,0,0,1,0,0,1,0,1,0,1,1,0,1,1
Japan,JP,JPN,Asia,2019,24787,8563,1872,4841,4168,1676,6290,6040,3548,6018,5939,5844,7467,7388,7716,7116
Japan,JP,JPN,Asia,2018,125065,45066,12208,26679,19814,8029,36250,32022,20237,31606,30571,27843,41177,40142,40051,35498
Japan,JP,JPN,Asia,2017,133885,59462,24379,30687,18089,9941,50215,42468,34320,34436,36188,28030,53964,55716,52409,39937
Japan,JP,JPN,Asia,2016,124287,57785,24581,28788,15321,10512,48778,39902,35093,31753,34832,25833,51743,54822,50414,37797
Japan,JP,JPN,Asia,2015,117664,53939,23426,26837,13706,9840,45649,37132,33266,29191,32773,23546,48003,51585,46972,35127
Japan,JP,JPN,Asia,2014,122311,55204,27864,24479,11330,9133,47375,39194,36997,26493,30295,20463,49389,53191,48327,32309
Japan,JP,JPN,Asia,2013,124110,53789,29583,22805,9394,7986,47501,38977,37569,24342,27559,17380,49038,52255,46963,29096
Japan,JP,JPN,Asia,2012,119780,50332,30187,19984,7546,6352,45205,37733,36539,21494,23601,13898,46715,48822,44085,25111
Japan,JP,JPN,Asia,2011,119145,46091,29454,17397,5374,4962,41964,34828,34416,18635,20286,10336,43202,44853,39790,21524
Japan,JP,JPN,Asia,2010,117695,43529,29272,15237,4108,3970,39725,33380,33242,16595,17684,8078,41083,42172,37350,19042
Japan,JP,JPN,Asia,2009,115115,41925,29975,13823,2821,3192,39085,32796,33167,14689,15801,6013,39951,41063,35988,16667
Jordan,JO,JOR,Asia,2047,1,1,0,0,0,1,0,0,1,0,1,1,0,1,1,1
Jordan,JO,JOR,Asia,2019,685,231,23,96,141,50,114,164,73,172,137,191,190,155,214,213
Jordan,JO,JOR,Asia,2018,3534,1204,155,527,678,298,650,833,453,865,743,976,988,866,1131,1081
Jordan,JO,JOR,Asia,2017,3176,1243,215,508,529,370,675,744,585,778,806,899,945,973,1114,1076
Jordan,JO,JOR,Asia,2016,3001,1216,253,459,384,441,676,637,694,671,787,825,888,1004,1078,999
Jordan,JO,JOR,Asia,2015,2484,1015,220,410,289,391,581,509,611,543,711,680,714,882,900,844
Jordan,JO,JOR,Asia,2014,2399,916,249,359,250,301,559,499,550,474,601,551,674,801,800,716
Jordan,JO,JOR,Asia,2013,2402,822,246,302,246,229,496,492,475,437,493,475,631,687,721,628
Jordan,JO,JOR,Asia,2012,2105,790,301,279,175,219,548,476,520,366,434,394,635,703,695,521
Jordan,JO,JOR,Asia,2011,1806,581,188,248,139,176,406,327,364,310,361,315,468,519,503,423
Jordan,JO,JOR,Asia,2010,1708,452,150,222,94,90,336,244,240,264,296,184,378,410,334,338
Jordan,JO,JOR,Asia,2009,1534,376,118,156,84,110,244,202,228,202,242,194,290,330,312,288
Kazakhstan,KZ,KAZ,Asia,2019,216,74,5,47,44,9,50,49,14,64,54,53,67,57,58,71
Kazakhstan,KZ,KAZ,Asia,2018,1151,427,38,242,201,102,270,239,140,332,309,303,360,337,341,399
Kazakhstan,KZ,KAZ,Asia,2017,1099,477,53,257,181,135,302,234,188,334,355,316,379,400,369,432
Kazakhstan,KZ,KAZ,Asia,2016,917,442,64,229,139,128,277,203,192,304,319,267,352,367,331,394
Kazakhstan,KZ,KAZ,Asia,2015,837,409,54,202,123,132,240,177,186,268,305,255,306,343,309,371
Kazakhstan,KZ,KAZ,Asia,2014,823,405,28,196,148,141,220,176,169,255,322,289,279,346,317,381
Kazakhstan,KZ,KAZ,Asia,2013,596,266,36,100,108,74,128,144,110,180,158,182,208,186,218,238
Kazakhstan,KZ,KAZ,Asia,2012,516,271,33,91,153,51,113,186,84,227,113,204,249,135,237,249
Kazakhstan,KZ,KAZ,Asia,2011,234,88,15,37,18,33,49,33,48,51,62,51,63,74,66,76
Kazakhstan,KZ,KAZ,Asia,2010,164,52,14,24,14,9,34,28,23,36,30,23,46,40,37,42
Kazakhstan,KZ,KAZ,Asia,2009,152,27,9,18,4,3,23,13,12,21,19,7,26,24,16,22
Kuwait,KW,KWT,Asia,2019,251,85,8,43,57,14,49,65,22,67,55,71,73,61,79,79
Kuwait,KW,KWT,Asia,2018,1144,395,49,231,256,46,272,305,95,329,256,302,370,297,351,354
Kuwait,KW,KWT,Asia,2017,1070,417,73,229,229,77,290,302,150,309,276,306,370,337,379,356
Kuwait,KW,KWT,Asia,2016,992,388,70,224,178,84,274,248,154,281,281,262,331,331,332,338
Kuwait,KW,KWT,Asia,2015,883,351,73,202,147,84,250,220,157,245,260,231,293,308,304,303
Kuwait,KW,KWT,Asia,2014,833,319,66,184,139,68,234,205,134,220,233,207,270,283,273,269
Kuwait,KW,KWT,Asia,2013,800,284,66,170,134,46,221,200,112,198,205,180,249,256,246,233
Kuwait,KW,KWT,Asia,2012,747,242,87,120,85,45,184,172,132,146,152,130,210,216,217,178
Kuwait,KW,KWT,Asia,2011,721,246,106,95,72,46,184,178,152,120,132,118,209,221,224,157
Kuwait,KW,KWT,Asia,2010,694,187,85,80,48,28,150,133,113,95,102,76,165,172,161,117
Kuwait,KW,KWT,Asia,2009,669,156,76,67,32,28,130,108,104,76,84,60,139,147,136,93
Kyrgyzstan,KG,KGZ,Asia,2019,17,6,2,2,1,3,4,3,5,3,3,4,5,5,6,4
Kyrgyzstan,KG,KGZ,Asia,2018,80,46,6,23,24,15,29,30,21,38,25,39,44,31,45,40
Kyrgyzstan,KG,KGZ,Asia,2017,68,37,6,19,15,14,25,21,20,29,21,29,35,27,35,31
Kyrgyzstan,KG,KGZ,Asia,2016,48,22,2,12,16,3,14,18,5,18,14,19,20,16,21,20
Kyrgyzstan,KG,KGZ,Asia,2015,35,11,3,6,5,2,7,8,5,9,7,7,10,8,10,10
Kyrgyzstan,KG,KGZ,Asia,2014,31,10,0,9,4,3,9,4,3,9,10,7,9,10,7,10
Kyrgyzstan,KG,KGZ,Asia,2013,44,13,2,8,4,4,9,6,6,8,12,8,9,13,10,12
Kyrgyzstan,KG,KGZ,Asia,2012,32,14,4,9,8,0,13,12,4,10,9,8,14,13,12,10
Kyrgyzstan,KG,KGZ,Asia,2011,20,3,1,1,1,1,2,2,2,1,2,2,2,3,3,2
Kyrgyzstan,KG,KGZ,Asia,2010,10,4,1,1,3,0,2,4,1,3,1,3,4,2,4,3
Kyrgyzstan,KG,KGZ,Asia,2009,8,0,0,0,0,0,0,0,0,0,0,0,0,0,0,0
Laos,LA,LAO,Asia,2019,40,23,1,13,17,3,14,18,4,20,15,20,21,16,21,22
Laos,LA,LAO,Asia,2018,180,92,5,72,62,22,75,67,27,79,82,84,82,85,89,89
Laos,LA,LAO,Asia,2017,134,78,16,63,39,20,73,55,36,65,66,59,75,76,75,68
Laos,LA,LAO,Asia,2016,136,80,15,60,39,19,70,54,34,64,66,58,74,76,73,70
Laos,LA,LAO,Asia,2015,154,96,23,82,37,27,90,60,50,84,86,64,92,94,87,88
Laos,LA,LAO,Asia,2014,128,61,17,37,28,15,49,45,32,41,45,43,53,57,60,49
Laos,LA,LAO,Asia,2013,108,52,17,32,23,8,45,40,25,35,36,31,48,49,48,39
Laos,LA,LAO,Asia,2012,126,71,37,38,18,9,63,55,46,40,44,27,65,69,64,46
Laos,LA,LAO,Asia,2011,104,54,24,35,21,4,51,45,28,36,37,25,52,53,49,38
Laos,LA,LAO,Asia,2010,109,40,27,23,6,2,39,33,29,23,24,8,39,40,35,24
Laos,LA,LAO,Asia,2009,90,41,22,26,11,2,41,33,24,26,26,13,41,41,35,26
Lebanon,LB,LBN,Asia,2019,507,164,8,103,110,32,108,118,40,142,120,142,147,125,150,159
Lebanon,LB,LBN,Asia,2018,2738,906,80,582,579,141,639,659,221,768,663,720,825,720,800,849
Lebanon,LB,LBN,Asia,2017,2506,962,161,633,432,194,750,593,355,718,761,626,835,878,787,846
Lebanon,LB,LBN,Asia,2016,2118,867,155,575,335,192,664,490,347,666,687,527,755,776,682,778
Lebanon,LB,LBN,Asia,2015,1786,732,148,473,309,153,565,457,301,538,575,462,630,667,610,640
Lebanon,LB,LBN,Asia,2014,1787,721,163,453,246,170,558,409,333,503,566,416,608,671,579,616
Lebanon,LB,LBN,Asia,2013,1597,562,181,335,150,119,459,331,300,358,415,269,482,539,450,438
Lebanon,LB,LBN,Asia,2012,1336,474,138,289,134,96,387,272,234,312,353,230,410,451,368,376
Lebanon,LB,LBN,Asia,2011,1172,356,124,196,87,79,279,211,203,220,249,166,303,332,290,273
Lebanon,LB,LBN,Asia,2010,1078,305,125,180,50,50,262,175,175,193,210,100,275,292,225,223
Lebanon,LB,LBN,Asia,2009,977,246,116,142,41,30,215,157,146,155,160,71,228,233,187,173
Macao,MO,MAC,Asia,2019,466,98,6,63,70,14,68,76,20,82,74,84,87,79,90,93
Macao,MO,MAC,Asia,2018,2225,562,31,385,383,85,403,414,116,481,448,468,499,466,499,544
Macao,MO,MAC,Asia,2017,2114,629,70,442,361,114,486,431,184,523,504,475,567,548,545,585
Macao,MO,MAC,Asia,2016,1762,524,84,384,256,82,436,340,166,429,427,338,481,479,422,472
Macao,MO,MAC,Asia,2015,1384,383,72,262,194,45,310,266,117,308,289,239,356,337,311,335
Macao,MO,MAC,Asia,2014,1191,301,58,209,154,29,245,212,87,250,224,183,286,260,241,265
Macao,MO,MAC,Asia,2013,908,207,34,124,106,30,146,140,64,161,148,136,183,170,170,185
Macao,MO,MAC,Asia,2012,719,189,42,99,85,36,130,127,78,131,126,121,162,157,163,158
Macao,MO,MAC,Asia,2011,538,111,39,62,28,23,86,67,62,70,79,51,94,103,90,87
Macao,MO,MAC,Asia,2010,442,94,32,59,29,12,77,61,44,68,67,41,86,85,73,76
Macao,MO,MAC,Asia,2009,346,69,31,51,10,13,63,41,44,52,56,23,64,68,54,57
Malaysia,MY,MYS,Asia,2019,3776,1576,152,633,911,458,759,1063,610,1086,997,1369,1212,1123,1521,1450
Malaysia,MY,MYS,Asia,2018,23048,10936,1666,4200,5470,3245,5519,7136,4911,7030,6787,8715,8349,8106,10381,9617
Malaysia,MY,MYS,Asia,2017,22896,11325,2127,4815,4762,3523,6540,6889,5650,6947,7468,8285,8672,9193,10412,9600
Malaysia,MY,MYS,Asia,2016,20793,10748,2336,4664,4096,3388,6545,6432,5724,6244,7287,7484,8125,9168,9820,8867
Malaysia,MY,MYS,Asia,2015,20895,9721,2984,3909,2860,3048,6322,5844,6032,4917,6301,5908,7330,8714,8892,7309
Malaysia,MY,MYS,Asia,2014,20423,9354,2228,4262,3324,2897,6056,5552,5125,5246,6576,6221,7040,8370,8449,7560
Malaysia,MY,MYS,Asia,2013,18254,8035,2418,3176,2247,2583,5123,4665,5001,4001,5264,4830,5948,7211,7248,6089
Malaysia,MY,MYS,Asia,2012,14844,6876,1762,2606,2254,2361,4051,4016,4123,3325,4712,4615,4770,6157,6377,5431
Malaysia,MY,MYS,Asia,2011,11364,4744,1481,2261,1476,1322,3420,2957,2803,2528,3318,2798,3687,4477,4279,3585
Malaysia,MY,MYS,Asia,2010,8080,3613,1083,1852,1285,904,2672,2368,1987,2093,2552,2189,2913,3372,3272,2793
Malaysia,MY,MYS,Asia,2009,6121,2608,867,1459,822,620,2065,1689,1487,1610,1851,1442,2216,2457,2309,2002
Maldives,MV,MDV,Asia,2018,3,3,0,3,3,0,3,3,0,3,3,3,3,3,3,3
Maldives,MV,MDV,Asia,2017,1,1,0,1,0,1,1,0,1,1,1,1,1,1,1,1
Maldives,MV,MDV,Asia,2015,5,2,1,2,0,0,2,1,1,2,2,0,2,2,1,2
Maldives,MV,MDV,Asia,2014,2,0,0,0,0,0,0,0,0,0,0,0,0,0,0,0
Maldives,MV,MDV,Asia,2013,1,1,1,0,0,0,1,1,1,0,0,0,1,1,1,0
Maldives,MV,MDV,Asia,2011,6,5,0,5,3,0,5,3,0,5,5,3,5,5,3,5
Maldives,MV,MDV,Asia,2010,2,1,0,0,1,0,0,1,0,1,0,1,1,0,1,1
Maldives,MV,MDV,Asia,2009,2,1,1,0,0,0,1,1,1,0,0,0,1,1,1,0
Mongolia,MN,MNG,Asia,2019,60,17,2,11,10,3,13,12,5,13,13,13,15,15,15,15
Mongolia,MN,MNG,Asia,2018,325,131,17,63,87,19,74,104,36,106,77,106,117,88,123,120
Mongolia,MN,MNG,Asia,2017,276,132,14,47,82,27,56,96,41,103,67,109,112,76,123,123
Mongolia,MN,MNG,Asia,2016,264,128,22,67,64,34,85,86,56,94,83,98,112,101,120,110
Mongolia,MN,MNG,Asia,2015,220,90,24,38,31,23,56,55,47,54,56,54,72,74,78,72
Mongolia,MN,MNG,Asia,2014,249,105,22,34,56,17,52,78,39,76,45,73,94,63,95,87
Mongolia,MN,MNG,Asia,2013,190,66,36,22,11,16,52,47,52,25,33,27,55,63,63,36
Mongolia,MN,MNG,Asia,2012,131,42,15,26,11,15,38,26,30,27,29,26,39,41,41,30
Mongolia,MN,MNG,Asia,2011,142,49,19,21,6,18,40,25,37,22,29,24,41,48,43,30
Mongolia,MN,MNG,Asia,2010,129,43,21,15,5,14,32,26,35,19,22,19,36,39,40,26
Mongolia,MN,MNG,Asia,2009,124,40,17,22,3,11,39,20,28,22,23,14,39,40,31,23
Myanmar,MM,MMR,Asia,2019,16,9,1,5,6,2,6,7,3,6,7,8,7,8,9,8
Myanmar,MM,MMR,Asia,2018,82,33,4,12,16,12,16,20,16,20,21,28,24,25,32,29
Myanmar,MM,MMR,Asia,2017,70,39,8,17,15,16,23,23,24,21,29,31,27,35,39,33
Myanmar,MM,MMR,Asia,2016,56,34,3,13,14,14,15,17,17,19,26,28,21,28,31,32
Myanmar,MM,MMR,Asia,2015,48,21,7,10,12,2,15,19,9,15,11,14,20,16,21,16
Myanmar,MM,MMR,Asia,2014,40,12,4,7,4,3,9,8,7,8,9,7,10,11,11,10
Myanmar,MM,MMR,Asia,2013,34,11,3,3,6,2,5,9,5,8,4,8,10,6,11,9
Myanmar,MM,MMR,Asia,2012,43,12,5,6,3,3,8,8,8,7,9,6,9,11,11,10
Myanmar,MM,MMR,Asia,2011,36,13,9,7,2,2,11,11,11,8,8,4,12,12,13,9
Myanmar,MM,MMR,Asia,2010,32,3,1,2,1,1,3,2,2,2,2,2,3,3,3,2
Myanmar,MM,MMR,Asia,2009,18,4,3,2,0,0,4,3,3,2,2,0,4,4,3,2
Nepal,NP,NPL,Asia,2019,210,126,8,56,93,23,63,101,31,102,73,116,109,80,124,119
Nepal,NP,NPL,Asia,2018,1703,1146,313,348,596,224,629,909,537,689,524,820,970,805,1133,865
Nepal,NP,NPL,Asia,2017,1581,1213,393,332,496,295,704,889,688,596,577,791,968,949,1184,841
Nepal,NP,NPL,Asia,2016,1208,874,227,295,391,215,507,618,442,489,468,606,701,680,833,662
Nepal,NP,NPL,Asia,2015,1277,955,359,275,328,216,605,687,575,440,460,544,770,790,903,625
Nepal,NP,NPL,Asia,2014,1087,802,352,199,337,85,517,689,437,411,272,422,729,590,774,484
Nepal,NP,NPL,Asia,2013,1151,888,471,184,275,106,625,746,577,359,272,381,800,713,852,447
Nepal,NP,NPL,Asia,2012,877,641,361,115,199,58,452,560,419,256,163,257,593,500,618,304
Nepal,NP,NPL,Asia,2011,571,406,218,85,139,29,289,357,247,182,105,168,386,309,386,202
Nepal,NP,NPL,Asia,2010,712,519,299,126,171,33,375,470,332,250,146,204,499,395,503,270
Nepal,NP,NPL,Asia,2009,365,260,132,69,89,20,182,221,152,131,85,109,244,198,241,147
North Korea,KP,PRK,Asia,2019,21,4,0,4,0,0,4,0,0,4,4,0,4,4,0,4
North Korea,KP,PRK,Asia,2018,78,16,0,10,9,1,10,9,1,16,10,10,16,10,10,16
North Korea,KP,PRK,Asia,2017,75,23,6,11,6,3,17,12,9,15,13,9,21,19,15,17
North Korea,KP,PRK,Asia,2016,48,18,3,14,5,1,17,8,4,14,15,6,17,18,9,15
North Korea,KP,PRK,Asia,2015,33,14,4,8,2,1,12,6,5,9,9,3,13,13,7,10
North Korea,KP,PRK,Asia,2014,23,9,1,6,2,1,7,3,2,7,7,3,8,8,4,8
North Korea,KP,PRK,Asia,2013,11,6,1,5,0,0,6,1,1,5,5,0,6,6,1,5
North Korea,KP,PRK,Asia,2012,7,2,0,2,0,1,2,0,1,2,2,1,2,2,1,2
North Korea,KP,PRK,Asia,2011,8,4,1,2,0,2,3,1,3,2,3,2,3,4,3,3
North Korea,KP,PRK,Asia,2010,9,3,0,3,1,1,3,1,1,3,3,2,3,3,2,3
North Korea,KP,PRK,Asia,2009,9,2,0,1,0,2,1,0,2,1,2,2,1,2,2,2
Oman,OM,OMN,Asia,2019,247,75,3,35,64,6,37,67,9,70,38,70,72,40,73,73
Oman,OM,OMN,Asia,2018,1140,406,46,203,277,55,238,323,101,333,241,332,368,276,378,371
Oman,OM,OMN,Asia,2017,1148,484,65,246,291,94,295,356,159,361,320,385,410,369,450,435
Oman,OM,OMN,Asia,2016,1102,528,57,229,312,105,276,369,162,393,317,417,440,364,474,481
Oman,OM,OMN,Asia,2015,1098,498,85,209,289,74,277,374,159,372,267,363,440,335,448,430
Oman,OM,OMN,Asia,2014,1019,417,83,180,211,84,252,294,167,272,253,295,344,325,378,345
Oman,OM,OMN,Asia,2013,936,393,65,222,207,78,270,272,143,281,286,285,329,334,350,345
Oman,OM,OMN,Asia,2012,759,266,64,130,129,45,183,193,109,178,165,174,231,218,238,213
Oman,OM,OMN,Asia,2011,654,213,60,100,82,31,149,142,91,140,124,113,189,173,173,164
Oman,OM,OMN,Asia,2010,505,161,54,76,68,19,114,122,73,110,89,87,148,127,141,123
Oman,OM,OMN,Asia,2009,472,138,43,66,43,16,100,86,59,93,77,59,127,111,102,104
Pakistan,PK,PAK,Asia,2108,1,1,0,1,1,0,1,1,0,1,1,1,1,1,1,1
Pakistan,PK,PAK,Asia,2019,3985,1380,125,645,890,324,754,1015,449,1046,870,1214,1155,979,1339,1271
Pakistan,PK,PAK,Asia,2018,19400,7626,1060,3814,4657,1549,4678,5717,2609,5728,4848,6206,6592,5712,7266,6762
Pakistan,PK,PAK,Asia,2017,18311,8443,1489,3940,4177,2041,5119,5666,3530,5833,5373,6218,7012,6552,7707,7266
Pakistan,PK,PAK,Asia,2016,14748,7124,1494,3486,3302,1664,4648,4796,3158,4903,4546,4966,6065,5708,6460,5963
Pakistan,PK,PAK,Asia,2015,12207,5735,1191,3046,2631,1341,3910,3822,2532,4007,3910,3972,4871,4774,5163,4871
Pakistan,PK,PAK,Asia,2014,11040,5188,1232,2745,2208,1142,3629,3440,2374,3505,3545,3350,4389,4429,4582,4305
Pakistan,PK,PAK,Asia,2013,9911,4457,1204,2342,1694,1037,3227,2898,2241,2892,3022,2731,3777,3907,3935,3572
Pakistan,PK,PAK,Asia,2012,8644,3766,1120,2123,1487,703,2917,2607,1823,2546,2549,2190,3340,3343,3310,2972
Pakistan,PK,PAK,Asia,2011,7412,3016,928,1684,1050,636,2373,1978,1564,1897,2114,1686,2586,2803,2614,2327
Pakistan,PK,PAK,Asia,2010,6185,2471,871,1314,845,426,1917,1716,1297,1539,1643,1271,2142,2246,2142,1868
Pakistan,PK,PAK,Asia,2009,5158,1833,702,1104,634,235,1530,1336,937,1241,1270,869,1667,1696,1571,1407
Philippines,PH,PHL,Asia,2019,434,175,14,94,114,38,108,128,52,133,122,152,147,136,166,161
Philippines,PH,PHL,Asia,2018,2427,939,121,480,478,290,576,599,411,684,639,768,780,735,889,843
Philippines,PH,PHL,Asia,2017,2260,966,179,477,429,284,610,608,463,643,667,713,776,800,892,833
Philippines,PH,PHL,Asia,2016,2095,994,157,500,436,294,610,593,451,678,706,730,788,816,887,884
Philippines,PH,PHL,Asia,2015,2020,942,175,444,330,314,568,505,489,559,703,644,683,827,819,818
Philippines,PH,PHL,Asia,2014,1806,691,180,357,226,177,488,406,357,426,491,403,557,622,583,560
Philippines,PH,PHL,Asia,2013,1672,672,206,322,189,176,479,395,382,376,462,365,533,619,571,516
Philippines,PH,PHL,Asia,2012,1452,491,160,249,152,95,370,312,255,303,316,247,424,437,407,370
Philippines,PH,PHL,Asia,2011,1142,381,144,198,99,51,308,243,195,235,234,150,345,344,294,271
Philippines,PH,PHL,Asia,2010,1030,322,140,178,78,31,272,218,171,212,194,109,306,288,249,228
Philippines,PH,PHL,Asia,2009,957,251,118,135,49,28,216,167,146,151,154,77,232,235,195,170
Qatar,QA,QAT,Asia,2019,471,136,7,81,99,21,86,106,28,115,97,120,120,102,127,131
Qatar,QA,QAT,Asia,2018,2127,683,59,462,425,120,501,484,179,574,532,545,613,571,604,644
Qatar,QA,QAT,Asia,2017,2192,848,83,618,361,160,674,444,243,703,707,521,759,763,604,792
Qatar,QA,QAT,Asia,2016,2068,827,129,578,355,153,647,484,282,677,659,508,746,728,637,758
Qatar,QA,QAT,Asia,2015,1707,674,104,469,255,134,535,359,238,523,554,389,589,620,493,608
Qatar,QA,QAT,Asia,2014,1327,510,84,337,202,118,389,286,202,386,409,320,438,461,404,458
Qatar,QA,QAT,Asia,2013,985,376,74,238,136,91,280,210,165,272,300,227,314,342,301,334
Qatar,QA,QAT,Asia,2012,965,291,71,178,109,52,224,180,123,208,215,161,254,261,232,245
Qatar,QA,QAT,Asia,2011,673,193,51,104,61,41,143,112,92,123,135,102,162,174,153,154
Qatar,QA,QAT,Asia,2010,536,153,48,93,48,13,134,96,61,105,100,61,146,141,109,112
Qatar,QA,QAT,Asia,2009,365,100,34,63,24,21,82,58,55,72,72,45,91,91,79,81
Saudi Arabia,SA,SAU,Asia,2020,1,1,1,1,0,0,1,1,1,1,1,0,1,1,1,1
Saudi Arabia,SA,SAU,Asia,2019,3522,1266,75,697,912,200,761,987,275,1079,820,1112,1143,884,1187,1202
Saudi Arabia,SA,SAU,Asia,2018,17067,6514,543,3825,4075,1074,4241,4618,1617,5465,4458,5149,5881,4874,5692,6098
Saudi Arabia,SA,SAU,Asia,2017,17658,7460,964,4358,3718,1443,5102,4682,2407,5805,5269,5161,6549,6013,6125,6716
Saudi Arabia,SA,SAU,Asia,2016,16119,7055,1096,4186,3274,1415,4996,4370,2511,5390,5041,4689,6200,5851,5785,6245
Saudi Arabia,SA,SAU,Asia,2015,14570,6296,990,3716,3031,1180,4454,4021,2170,4807,4468,4211,5545,5206,5201,5559
Saudi Arabia,SA,SAU,Asia,2014,13076,5335,962,3082,2525,989,3728,3487,1951,4007,3764,3514,4653,4410,4476,4689
Saudi Arabia,SA,SAU,Asia,2013,10846,4367,878,2307,1955,893,2933,2833,1771,3156,2892,2848,3782,3518,3726,3741
Saudi Arabia,SA,SAU,Asia,2012,9281,3692,850,2101,1649,659,2710,2499,1509,2648,2537,2308,3257,3146,3158,3084
Saudi Arabia,SA,SAU,Asia,2011,6960,2564,608,1452,1128,467,1885,1736,1075,1824,1759,1595,2257,2192,2203,2131
Saudi Arabia,SA,SAU,Asia,2010,4969,1754,453,930,750,294,1251,1203,747,1205,1158,1044,1526,1479,1497,1433
Saudi Arabia,SA,SAU,Asia,2009,3565,1057,309,522,403,187,737,712,496,691,673,590,906,888,899,842
Singapore,SG,SGP,Asia,2019,3589,1015,71,671,569,215,735,640,286,813,809,784,877,873,855,951
Singapore,SG,SGP,Asia,2018,17383,5090,400,3775,2734,926,4051,3134,1326,4400,4189,3660,4676,4465,4060,4814
Singapore,SG,SGP,Asia,2017,18358,6451,1079,4483,2567,1400,5207,3646,2479,4985,5226,3967,5709,5950,5046,5728
Singapore,SG,SGP,Asia,2016,16784,6041,1061,4312,2362,1257,4998,3423,2318,4680,4987,3619,5366,5673,4680,5355
Singapore,SG,SGP,Asia,2015,15848,5500,1064,3889,2048,1129,4531,3112,2193,4262,4485,3177,4904,5127,4241,4858
Singapore,SG,SGP,Asia,2014,15010,4787,1090,3356,1552,933,3996,2642,2023,3619,3884,2485,4259,4524,3575,4147
Singapore,SG,SGP,Asia,2013,14392,4217,1057,2924,1289,777,3589,2346,1834,3140,3337,2066,3805,4002,3123,3553
Singapore,SG,SGP,Asia,2012,13334,3861,1077,2577,1025,748,3243,2102,1825,2791,2981,1773,3457,3647,2850,3195
Singapore,SG,SGP,Asia,2011,12173,3138,1024,2060,746,563,2691,1770,1587,2204,2363,1309,2835,2994,2333,2507
Singapore,SG,SGP,Asia,2010,11219,2755,1000,1767,587,395,2369,1587,1395,1910,2010,982,2512,2612,1982,2153
Singapore,SG,SGP,Asia,2009,10013,2264,871,1472,337,337,2026,1208,1208,1517,1665,674,2071,2219,1545,1710
South Korea,KR,KOR,Asia,2019,16239,5254,320,3357,3285,1307,3637,3605,1627,4402,3932,4592,4682,4212,4912,4977
South Korea,KR,KOR,Asia,2018,82558,26723,2087,17405,15100,7546,18983,17187,9633,21648,20906,22646,23226,22484,24733,25149
South Korea,KR,KOR,Asia,2017,87376,33308,6754,19122,13723,10096,24416,20477,16850,22713,24425,23819,28007,29719,30573,28016
South Korea,KR,KOR,Asia,2016,90086,39103,13019,19502,12094,10914,30246,25113,23933,22242,25620,23008,32986,36364,36027,28360
South Korea,KR,KOR,Asia,2015,88078,39035,15692,18151,10801,9508,31394,26493,25200,20662,23282,20309,33905,36525,36001,25793
South Korea,KR,KOR,Asia,2014,86015,37261,17353,16130,8850,7770,31347,26203,25123,18151,20028,16620,33368,35245,33973,22049
South Korea,KR,KOR,Asia,2013,81540,34825,17654,14259,7045,6907,29821,24699,24561,16001,17523,13952,31563,33085,31606,19265
South Korea,KR,KOR,Asia,2012,75358,31795,17374,12114,5388,6116,27424,22762,23490,13943,14658,11504,29253,29968,28878,16487
South Korea,KR,KOR,Asia,2011,66682,25778,14617,9755,3480,4878,22601,18097,19495,10919,11771,8358,23765,24617,22975,12935
South Korea,KR,KOR,Asia,2010,58923,20535,11610,7990,2772,3299,17975,14382,14909,9143,9398,6071,19128,19383,17681,10551
South Korea,KR,KOR,Asia,2009,51425,17063,10574,6082,1845,2123,15182,12419,12697,7011,7036,3968,16111,16136,14542,7965
Sri Lanka,LK,LKA,Asia,2019,288,142,7,84,101,31,91,108,38,117,102,132,124,109,139,135
Sri Lanka,LK,LKA,Asia,2018,1990,1110,99,545,657,322,631,756,421,785,784,979,871,870,1078,1024
Sri Lanka,LK,LKA,Asia,2017,2051,1365,154,538,592,558,662,746,712,759,1020,1150,883,1144,1304,1241
Sri Lanka,LK,LKA,Asia,2016,2057,1336,104,455,449,723,532,553,827,638,1076,1172,715,1153,1276,1259
Sri Lanka,LK,LKA,Asia,2015,1783,1149,138,404,407,534,512,545,672,564,881,941,672,989,1079,1041
Sri Lanka,LK,LKA,Asia,2014,1507,1004,174,332,367,403,483,541,577,492,693,770,643,844,944,853
Sri Lanka,LK,LKA,Asia,2013,1435,911,295,256,244,322,529,539,617,368,526,566,641,799,861,638
Sri Lanka,LK,LKA,Asia,2012,1207,684,105,224,214,307,307,319,412,336,489,521,419,572,626,601
Sri Lanka,LK,LKA,Asia,2011,1270,821,83,222,162,528,283,245,611,300,682,690,361,743,773,760
Sri Lanka,LK,LKA,Asia,2010,991,541,66,149,103,326,204,169,392,193,442,429,248,497,495,486
Sri Lanka,LK,LKA,Asia,2009,1064,602,61,122,183,325,169,244,386,262,415,508,309,462,569,555
State of Palestine,PS,PSE,Asia,2019,276,85,5,50,61,16,55,66,21,68,62,77,73,67,82,80
State of Palestine,PS,PSE,Asia,2018,1427,445,81,274,241,86,340,322,167,348,305,327,414,371,408,379
State of Palestine,PS,PSE,Asia,2017,1427,623,207,345,231,117,507,438,324,399,407,348,561,569,555,461
State of Palestine,PS,PSE,Asia,2016,1144,540,156,326,186,127,440,342,283,367,385,313,481,499,469,426
State of Palestine,PS,PSE,Asia,2015,1045,465,128,268,147,121,371,275,249,292,338,268,395,441,396,362
State of Palestine,PS,PSE,Asia,2014,1060,464,189,223,129,93,374,318,282,256,280,222,407,431,411,313
State of Palestine,PS,PSE,Asia,2013,841,361,135,178,99,77,283,234,212,202,232,176,307,337,311,256
State of Palestine,PS,PSE,Asia,2012,773,291,124,123,81,61,226,205,185,140,171,142,243,274,266,188
State of Palestine,PS,PSE,Asia,2011,655,235,120,91,48,39,193,168,159,109,115,87,211,217,207,133
State of Palestine,PS,PSE,Asia,2010,561,188,98,79,34,29,156,132,127,92,98,63,169,175,161,111
State of Palestine,PS,PSE,Asia,2009,461,127,67,54,33,17,108,100,84,60,67,50,114,121,117,73
Syria,SY,SYR,Asia,2019,41,17,2,7,11,4,9,13,6,12,10,15,14,12,17,15
Syria,SY,SYR,Asia,2018,281,124,8,66,77,32,73,85,40,97,86,109,104,93,117,117
Syria,SY,SYR,Asia,2017,248,114,11,51,57,36,60,68,47,76,80,93,85,89,104,105
Syria,SY,SYR,Asia,2016,231,126,17,75,73,23,87,90,40,102,87,96,114,99,113,114
Syria,SY,SYR,Asia,2015,228,130,12,72,62,33,80,74,45,98,96,95,106,104,107,122
Syria,SY,SYR,Asia,2014,183,91,13,45,40,24,54,53,37,62,65,64,71,74,77,82
Syria,SY,SYR,Asia,2013,175,70,11,43,29,15,51,40,26,52,53,44,60,61,55,62
Syria,SY,SYR,Asia,2012,191,93,8,39,33,36,47,41,44,52,72,69,60,80,77,85
Syria,SY,SYR,Asia,2011,136,52,16,23,14,11,34,30,27,30,34,25,41,45,41,41
Syria,SY,SYR,Asia,2010,107,34,8,21,12,5,25,20,13,25,26,17,29,30,25,30
Syria,SY,SYR,Asia,2009,58,22,14,9,4,1,20,18,15,10,10,5,21,21,19,11
Taiwan,TW,TWN,Asia,2019,5488,1781,99,1123,1296,256,1209,1395,355,1540,1278,1552,1626,1364,1651,1695
Taiwan,TW,TWN,Asia,2018,28395,9616,798,6307,6513,1432,6894,7311,2230,8286,7050,7945,8873,7637,8743,9029
Taiwan,TW,TWN,Asia,2017,30457,11532,1874,7209,6457,2114,8487,8331,3988,9122,8341,8571,10400,9619,10445,10254
Taiwan,TW,TWN,Asia,2016,29915,11258,1945,7050,6141,1951,8364,8086,3896,8902,8094,8092,10216,9408,10037,9946
Taiwan,TW,TWN,Asia,2015,30816,11146,2091,6547,5441,2492,7982,7532,4583,8021,8238,7933,9456,9673,10024,9712
Taiwan,TW,TWN,Asia,2014,32059,10233,2154,5940,4801,2055,7386,6955,4209,7302,7425,6856,8748,8871,9010,8787
Taiwan,TW,TWN,Asia,2013,33748,9573,2335,5213,3938,2085,6833,6273,4420,6469,6699,6023,8089,8319,8358,7955
Taiwan,TW,TWN,Asia,2012,31234,8441,2416,4241,3013,1994,5940,5429,4410,5353,5631,5007,7052,7330,7423,6743
Taiwan,TW,TWN,Asia,2011,30847,6902,2417,3399,1924,1597,5048,4341,4014,4059,4595,3521,5708,6244,5938,5255
Taiwan,TW,TWN,Asia,2010,27362,5737,2217,2733,1379,1113,4232,3596,3330,3349,3624,2492,4848,5123,4709,4240
Taiwan,TW,TWN,Asia,2009,25808,5006,2013,2351,902,1063,3775,2915,3076,2739,3196,1965,4163,4620,3978,3584
Tajikistan,TJ,TJK,Asia,2019,25,13,2,7,8,2,9,10,4,9,9,10,11,11,12,11
Tajikistan,TJ,TJK,Asia,2018,171,81,3,36,54,19,38,57,22,64,51,73,66,53,76,79
Tajikistan,TJ,TJK,Asia,2017,106,59,11,17,23,17,27,34,28,35,31,40,45,41,51,49
Tajikistan,TJ,TJK,Asia,2016,102,45,10,16,11,18,25,21,28,21,31,29,30,40,39,36
Tajikistan,TJ,TJK,Asia,2015,76,39,7,20,14,6,27,21,13,28,24,20,35,31,27,32
Tajikistan,TJ,TJK,Asia,2014,65,30,6,11,20,3,16,26,9,22,14,23,27,19,29,25
Tajikistan,TJ,TJK,Asia,2013,79,29,11,11,6,6,21,17,17,15,15,12,25,25,23,19
Tajikistan,TJ,TJK,Asia,2012,57,26,9,9,7,8,18,16,17,12,14,15,21,23,24,17
Tajikistan,TJ,TJK,Asia,2011,41,14,6,7,4,1,11,10,7,10,7,5,14,11,11,10
Tajikistan,TJ,TJK,Asia,2010,34,5,3,3,0,2,4,3,5,3,4,2,4,5,5,4
Tajikistan,TJ,TJK,Asia,2009,36,8,6,4,0,2,7,6,8,4,5,2,7,8,8,5
Thailand,TH,THA,Asia,2019,2234,742,56,359,508,153,402,564,209,596,462,661,639,505,717,699
Thailand,TH,THA,Asia,2018,11987,4356,543,2494,2713,882,2876,3256,1425,3427,3041,3595,3809,3423,4138,3974
Thailand,TH,THA,Asia,2017,11796,4768,992,2542,2207,1121,3236,3199,2113,3288,3328,3328,3982,4022,4320,4074
Thailand,TH,THA,Asia,2016,10471,4403,981,2432,1925,999,3106,2906,1980,3048,3113,2924,3722,3787,3905,3729
Thailand,TH,THA,Asia,2015,9402,3846,868,2136,1624,910,2744,2492,1778,2610,2764,2534,3218,3372,3402,3238
Thailand,TH,THA,Asia,2014,9437,3791,905,1948,1460,1003,2601,2365,1908,2380,2706,2463,3033,3359,3368,3138
Thailand,TH,THA,Asia,2013,8898,3258,944,1714,1123,792,2388,2067,1736,2065,2233,1915,2739,2907,2859,2584
Thailand,TH,THA,Asia,2012,8123,3153,897,1522,1076,787,2152,1973,1684,1938,2107,1863,2568,2737,2760,2523
Thailand,TH,THA,Asia,2011,6808,2186,763,1101,591,536,1643,1354,1299,1249,1496,1127,1791,2038,1890,1644
Thailand,TH,THA,Asia,2010,6094,1782,682,932,483,327,1429,1165,1009,1042,1176,810,1539,1673,1492,1286
Thailand,TH,THA,Asia,2009,5339,1489,691,789,376,185,1276,1067,876,871,920,561,1358,1407,1252,1002
Turkey,TR,TUR,Asia,2020,1,1,1,0,0,0,1,1,1,0,0,0,1,1,1,0
Turkey,TR,TUR,Asia,2019,8415,2843,640,1253,1450,545,1699,2090,1185,2085,1565,1995,2531,2011,2635,2397
Turkey,TR,TUR,Asia,2018,40883,16000,4134,7686,7939,2724,10118,12073,6858,12136,9118,10663,14568,11550,14797,13568
Turkey,TR,TUR,Asia,2017,41062,18996,5982,9229,7599,3256,13076,13581,9238,13083,11295,10855,16930,15142,16837,15149
Turkey,TR,TUR,Asia,2016,42545,20464,6250,10389,7558,3767,14559,13808,10017,14068,12615,11325,18238,16785,17575,16294
Turkey,TR,TUR,Asia,2015,38764,18317,5363,9330,6659,3618,12628,12022,8981,12273,12076,10277,15571,15374,15640,15019
Turkey,TR,TUR,Asia,2014,35349,15776,4725,7995,5743,2904,10924,10468,7629,10656,10186,8647,13585,13115,13372,12847
Turkey,TR,TUR,Asia,2013,31476,12627,3710,5660,4140,2927,8395,7850,6637,7638,7916,7067,10373,10651,10777,9894
Turkey,TR,TUR,Asia,2012,26578,9713,3028,4278,2616,2558,6584,5644,5586,5413,6272,5174,7719,8578,8202,7407
Turkey,TR,TUR,Asia,2011,23599,7322,2456,3073,1755,1949,5034,4211,4405,3801,4633,3704,5762,6594,6160,5361
Turkey,TR,TUR,Asia,2010,21061,6274,2044,2610,1364,1792,4143,3408,3836,3215,4137,3156,4748,5670,5200,4742
Turkey,TR,TUR,Asia,2009,19676,5012,2127,2104,856,1033,3868,2983,3160,2448,2904,1889,4212,4668,4016,3248
Turkmenistan,TM,TKM,Asia,2018,1,0,0,0,0,0,0,0,0,0,0,0,0,0,0,0
Turkmenistan,TM,TKM,Asia,2017,2,0,0,0,0,0,0,0,0,0,0,0,0,0,0,0
Turkmenistan,TM,TKM,Asia,2012,1,0,0,0,0,0,0,0,0,0,0,0,0,0,0,0
Turkmenistan,TM,TKM,Asia,2011,1,0,0,0,0,0,0,0,0,0,0,0,0,0,0,0
United Arab Emirates,AE,ARE,Asia,2104,1,0,0,0,0,0,0,0,0,0,0,0,0,0,0,0
United Arab Emirates,AE,ARE,Asia,2019,844,232,15,129,148,51,141,163,66,187,162,199,199,174,214,220
United Arab Emirates,AE,ARE,Asia,2018,3683,1270,103,789,695,258,864,798,361,1027,957,953,1102,1032,1056,1195
United Arab Emirates,AE,ARE,Asia,2017,3579,1401,186,860,656,293,975,842,479,1097,1049,949,1212,1164,1135,1286
United Arab Emirates,AE,ARE,Asia,2016,2973,1163,184,712,430,278,836,614,462,850,901,708,974,1025,892,1039
United Arab Emirates,AE,ARE,Asia,2015,2580,980,157,586,354,263,687,511,420,703,762,617,804,863,774,879
United Arab Emirates,AE,ARE,Asia,2014,2270,787,194,454,270,177,589,464,371,536,570,447,671,705,641,652
United Arab Emirates,AE,ARE,Asia,2013,2120,669,158,390,218,144,511,376,302,454,484,362,575,605,520,548
United Arab Emirates,AE,ARE,Asia,2012,1810,612,209,303,154,127,452,363,336,366,400,281,515,549,490,463
United Arab Emirates,AE,ARE,Asia,2011,1682,530,206,287,122,97,438,328,303,314,352,219,465,503,425,379
United Arab Emirates,AE,ARE,Asia,2010,1446,359,121,218,77,68,296,198,189,248,251,145,326,329,266,281
United Arab Emirates,AE,ARE,Asia,2009,1280,295,108,167,48,48,248,156,156,181,200,96,262,281,204,214
Uzbekistan,UZ,UZB,Asia,2019,35,14,1,8,7,1,9,8,2,12,9,8,13,10,9,13
Uzbekistan,UZ,UZB,Asia,2018,176,62,7,41,22,3,47,29,10,54,43,25,60,49,32,56
Uzbekistan,UZ,UZB,Asia,2017,222,82,8,55,29,11,61,37,19,70,61,40,76,67,48,76
Uzbekistan,UZ,UZB,Asia,2016,228,73,5,47,25,14,51,30,19,59,57,39,63,61,44,69
Uzbekistan,UZ,UZB,Asia,2015,208,60,8,49,16,5,52,24,13,55,51,21,58,54,29,57
Uzbekistan,UZ,UZB,Asia,2014,194,50,8,35,11,4,42,19,12,40,38,15,47,45,23,43
Uzbekistan,UZ,UZB,Asia,2013,201,63,8,49,15,17,51,23,25,55,55,32,57,57,40,61
Uzbekistan,UZ,UZB,Asia,2012,177,45,15,30,12,5,40,27,20,34,31,17,44,41,32,35
Uzbekistan,UZ,UZB,Asia,2011,205,53,16,33,13,6,48,29,22,33,38,19,48,53,35,38
Uzbekistan,UZ,UZB,Asia,2010,207,52,8,39,14,10,45,22,18,39,46,24,45,52,32,46
Uzbekistan,UZ,UZB,Asia,2009,207,39,19,24,5,5,36,24,24,24,27,10,36,39,29,27
Vietnam,VN,VNM,Asia,2019,1188,386,56,197,248,46,248,304,102,303,229,294,354,280,350,335
Vietnam,VN,VNM,Asia,2018,5163,1659,328,754,882,282,1048,1210,610,1177,942,1164,1471,1236,1492,1365
Vietnam,VN,VNM,Asia,2017,3995,1492,328,720,578,326,1013,906,654,966,953,904,1259,1246,1232,1199
Vietnam,VN,VNM,Asia,2016,3233,1375,349,597,450,347,911,799,696,806,852,797,1120,1166,1146,1061
Vietnam,VN,VNM,Asia,2015,2440,990,270,485,348,210,722,618,480,607,631,558,844,868,828,753
Vietnam,VN,VNM,Asia,2014,2145,824,278,360,248,178,617,526,456,437,490,426,694,747,704,567
Vietnam,VN,VNM,Asia,2013,1752,678,223,310,181,182,502,404,405,366,430,363,558,622,586,486
Vietnam,VN,VNM,Asia,2012,1545,738,382,245,146,128,599,528,510,295,335,274,649,689,656,385
Vietnam,VN,VNM,Asia,2011,1113,388,127,167,108,100,277,235,227,201,244,208,311,354,335,278
Vietnam,VN,VNM,Asia,2010,837,295,124,135,44,63,236,168,187,144,186,107,245,287,231,195
Vietnam,VN,VNM,Asia,2009,689,253,153,101,38,31,230,191,184,104,121,69,233,250,222,124
Yemen,YE,YEM,Asia,2019,66,14,1,9,13,0,10,14,1,13,9,13,14,10,14,13
Yemen,YE,YEM,Asia,2018,330,98,12,34,66,20,41,78,32,74,51,86,81,58,98,91
Yemen,YE,YEM,Asia,2017,315,133,30,46,62,33,71,92,63,77,77,95,102,102,125,108
Yemen,YE,YEM,Asia,2016,268,107,14,59,62,23,69,76,37,83,73,85,93,83,99,97
Yemen,YE,YEM,Asia,2015,243,113,28,55,57,19,77,85,47,76,70,76,98,92,104,91
Yemen,YE,YEM,Asia,2014,231,96,19,55,56,13,71,75,32,71,64,69,87,80,88,80
Yemen,YE,YEM,Asia,2013,204,67,8,39,42,11,44,50,19,53,48,53,58,53,61,62
Yemen,YE,YEM,Asia,2012,182,78,17,47,45,12,62,62,29,54,56,57,69,71,74,63
Yemen,YE,YEM,Asia,2011,146,52,23,20,13,13,38,36,36,23,31,26,41,49,49,34
Yemen,YE,YEM,Asia,2010,91,38,13,25,12,6,32,25,19,28,28,18,35,35,31,31
Yemen,YE,YEM,Asia,2009,73,20,6,12,7,3,16,13,9,14,14,10,18,18,16,16
Aland Islands,AX,ALA,Europe,2019,1,1,0,1,1,0,1,1,0,1,1,1,1,1,1,1
Aland Islands,AX,ALA,Europe,2018,2,0,0,0,0,0,0,0,0,0,0,0,0,0,0,0
Aland Islands,AX,ALA,Europe,2017,1,0,0,0,0,0,0,0,0,0,0,0,0,0,0,0
Aland Islands,AX,ALA,Europe,2016,1,0,0,0,0,0,0,0,0,0,0,0,0,0,0,0
Aland Islands,AX,ALA,Europe,2015,6,2,1,2,0,1,2,1,2,2,2,1,2,2,2,2
Aland Islands,AX,ALA,Europe,2014,4,3,0,3,1,0,3,1,0,3,3,1,3,3,1,3
Aland Islands,AX,ALA,Europe,2013,2,2,0,2,1,0,2,1,0,2,2,1,2,2,1,2
Aland Islands,AX,ALA,Europe,2012,3,1,0,1,1,0,1,1,0,1,1,1,1,1,1,1
Aland Islands,AX,ALA,Europe,2011,5,3,0,2,2,0,2,2,0,3,2,2,3,2,2,3
Aland Islands,AX,ALA,Europe,2009,3,0,0,0,0,0,0,0,0,0,0,0,0,0,0,0
Albania,AL,ALB,Europe,2019,42,21,5,4,12,3,9,17,8,13,7,15,18,12,20,16
Albania,AL,ALB,Europe,2018,226,98,16,38,52,24,54,68,40,60,60,76,76,76,92,82
Albania,AL,ALB,Europe,2017,259,146,38,65,43,57,95,81,95,82,99,100,112,129,138,116
Albania,AL,ALB,Europe,2016,279,192,63,55,39,78,111,102,141,73,118,117,129,174,180,136
Albania,AL,ALB,Europe,2015,317,215,26,89,60,110,110,86,136,109,174,170,130,195,196,194
Albania,AL,ALB,Europe,2014,306,222,13,68,42,139,78,55,152,90,190,181,100,200,194,212
Albania,AL,ALB,Europe,2013,324,235,18,42,18,184,56,36,202,49,214,202,63,228,220,221
Albania,AL,ALB,Europe,2012,116,58,15,14,17,18,27,32,33,27,32,35,40,45,50,45
Albania,AL,ALB,Europe,2011,79,32,9,11,12,4,20,21,13,19,15,16,28,24,25,23
Albania,AL,ALB,Europe,2010,83,32,16,12,13,1,24,29,17,20,12,14,32,24,30,20
Albania,AL,ALB,Europe,2009,41,13,7,5,4,1,10,11,8,7,6,5,12,11,12,8
Austria,AT,AUT,Europe,2103,1,1,0,1,0,0,1,0,0,1,1,0,1,1,0,1
Austria,AT,AUT,Europe,2019,4627,2007,160,1274,963,661,1398,1123,821,1491,1666,1624,1615,1790,1784,1883
Austria,AT,AUT,Europe,2018,23586,10502,1085,7736,4498,3233,8415,5583,4318,8637,8922,7731,9316,9601,8816,9823
Austria,AT,AUT,Europe,2017,23885,11854,2111,8496,4066,3385,9845,6177,5496,9198,9805,7451,10547,11154,9562,10507
Austria,AT,AUT,Europe,2016,22957,11946,2271,8308,3648,3642,9689,5919,5913,9032,9841,7290,10413,11222,9561,10565
Austria,AT,AUT,Europe,2015,21693,10217,2231,7284,3059,2718,8607,5290,4949,7768,8410,5777,9091,9733,8008,8894
Austria,AT,AUT,Europe,2014,20886,9394,2331,6670,2513,2321,8022,4844,4652,7076,7636,4834,8428,8988,7165,8042
Austria,AT,AUT,Europe,2013,20849,8857,2602,6113,2072,2207,7701,4674,4809,6430,6952,4279,8018,8540,6881,7269
Austria,AT,AUT,Europe,2012,19628,7812,2450,5307,1632,1992,6771,4082,4442,5579,6076,3624,7043,7540,6074,6348
Austria,AT,AUT,Europe,2011,19028,6878,2389,4556,1157,1638,5977,3546,4027,4783,5230,2795,6204,6651,5184,5457
Austria,AT,AUT,Europe,2010,18500,6227,2587,3956,942,1024,5499,3529,3611,4172,4468,1966,5715,6011,4553,4684
Austria,AT,AUT,Europe,2009,17138,5397,2358,3252,763,743,4700,3121,3101,3533,3668,1506,4981,5116,3864,3949
Belarus,BY,BLR,Europe,2019,316,163,4,78,58,96,80,62,100,86,153,154,88,155,158,161
Belarus,BY,BLR,Europe,2018,1413,571,20,365,318,186,385,338,206,450,466,504,470,486,524,551
Belarus,BY,BLR,Europe,2017,1215,459,33,325,253,103,351,286,136,377,381,356,403,407,389,433
Belarus,BY,BLR,Europe,2016,1143,440,35,322,212,120,354,247,155,358,372,332,390,404,367,408
Belarus,BY,BLR,Europe,2015,1039,365,40,260,196,87,290,236,127,307,288,283,337,318,323,335
Belarus,BY,BLR,Europe,2014,981,312,46,231,142,73,263,188,119,258,253,215,290,285,261,280
Belarus,BY,BLR,Europe,2013,952,236,35,179,38,126,205,73,161,192,197,164,218,223,199,210
Belarus,BY,BLR,Europe,2012,1001,287,34,226,23,174,253,57,208,235,251,197,262,278,231,260
Belarus,BY,BLR,Europe,2011,864,188,48,145,14,94,177,62,142,147,154,108,179,186,156,156
Belarus,BY,BLR,Europe,2010,899,146,54,112,25,28,130,79,82,116,124,53,134,142,107,128
Belarus,BY,BLR,Europe,2009,782,90,21,61,12,17,77,33,38,66,69,29,82,85,50,74
Belgium,BE,BEL,Europe,2019,6367,2244,152,1626,1213,459,1735,1365,611,1912,1849,1672,2021,1958,1824,2135
Belgium,BE,BEL,Europe,2018,31303,12262,1256,9770,6057,2251,10491,7313,3507,10833,10480,8308,11554,11201,9564,11543
Belgium,BE,BEL,Europe,2017,32771,15199,2946,11566,5380,2688,13356,8326,5634,12492,12483,8068,14282,14273,11014,13409
Belgium,BE,BEL,Europe,2016,30243,14413,3062,11009,4661,2677,12691,7723,5739,11718,12024,7338,13400,13706,10400,12733
Belgium,BE,BEL,Europe,2015,29124,13645,3040,10274,4338,2538,12016,7378,5578,10808,11369,6876,12550,13111,9916,11903
Belgium,BE,BEL,Europe,2014,28547,12692,3313,9391,3707,2052,11223,7020,5365,9882,10370,5759,11714,12202,9072,10861
Belgium,BE,BEL,Europe,2013,27414,11675,3395,8381,2913,1930,10365,6308,5325,8775,9297,4843,10759,11281,8238,9691
Belgium,BE,BEL,Europe,2012,25570,10570,3283,7512,2454,1698,9352,5737,4981,7951,8291,4152,9791,10131,7435,8730
Belgium,BE,BEL,Europe,2011,24029,9652,3268,6842,1809,1507,8620,5077,4775,7140,7577,3316,8918,9355,6584,7875
Belgium,BE,BEL,Europe,2010,25109,8724,3270,5991,1367,1101,7817,4637,4371,6352,6537,2468,8178,8363,5738,6898
Belgium,BE,BEL,Europe,2009,21565,7343,3049,4833,990,867,6649,4039,3916,5083,5279,1857,6899,7095,4906,5529
Bosnia and Herzegovina,BA,BIH,Europe,2019,273,106,16,49,61,23,63,77,39,77,64,84,91,78,100,92
Bosnia and Herzegovina,BA,BIH,Europe,2018,1313,606,104,268,371,77,349,475,181,469,324,448,550,405,552,525
Bosnia and Herzegovina,BA,BIH,Europe,2017,1240,706,156,317,337,107,436,493,263,504,400,444,623,519,600,587
Bosnia and Herzegovina,BA,BIH,Europe,2016,1046,580,95,282,260,107,350,355,202,427,367,367,495,435,462,512
Bosnia and Herzegovina,BA,BIH,Europe,2015,952,500,82,237,203,111,302,285,193,354,318,314,419,383,396,435
Bosnia and Herzegovina,BA,BIH,Europe,2014,879,509,102,206,217,97,282,319,199,353,286,314,429,362,416,433
Bosnia and Herzegovina,BA,BIH,Europe,2013,792,407,89,149,169,91,213,258,180,265,227,260,329,291,349,343
Bosnia and Herzegovina,BA,BIH,Europe,2012,663,319,65,137,139,61,177,204,126,239,177,200,279,217,265,279
Bosnia and Herzegovina,BA,BIH,Europe,2011,490,196,49,82,88,30,113,137,79,145,102,118,176,133,167,165
Bosnia and Herzegovina,BA,BIH,Europe,2010,379,144,71,86,39,15,116,110,86,103,97,54,133,127,125,114
Bosnia and Herzegovina,BA,BIH,Europe,2009,294,102,54,64,25,9,84,79,63,75,71,34,95,91,88,82
Bulgaria,BG,BGR,Europe,2019,515,211,31,120,128,25,148,159,56,171,132,153,199,160,184,183
Bulgaria,BG,BGR,Europe,2018,2834,1371,140,833,772,244,942,912,384,1137,958,1016,1246,1067,1156,1262
Bulgaria,BG,BGR,Europe,2017,2906,1481,279,856,701,287,1039,980,566,1127,1027,988,1310,1210,1267,1298
Bulgaria,BG,BGR,Europe,2016,2826,1512,301,807,627,352,1019,928,653,1091,1017,979,1303,1229,1280,1301
Bulgaria,BG,BGR,Europe,2015,2459,1206,276,648,498,238,837,774,514,874,791,736,1063,980,1012,1017
Bulgaria,BG,BGR,Europe,2014,2383,1114,232,585,419,304,750,651,536,728,806,723,893,971,955,949
Bulgaria,BG,BGR,Europe,2013,2376,1035,351,491,255,268,766,606,619,610,641,523,885,916,874,760
Bulgaria,BG,BGR,Europe,2012,2238,981,393,500,225,216,772,618,609,619,590,441,891,862,834,709
Bulgaria,BG,BGR,Europe,2011,2025,736,229,409,160,194,570,389,423,475,509,354,636,670,583,575
Bulgaria,BG,BGR,Europe,2010,2142,781,353,374,122,152,621,475,505,434,474,274,681,721,627,534
Bulgaria,BG,BGR,Europe,2009,2039,618,247,313,88,119,506,335,366,354,384,207,547,577,454,425
Croatia,HR,HRV,Europe,2023,1,0,0,0,0,0,0,0,0,0,0,0,0,0,0,0
Croatia,HR,HRV,Europe,2019,771,365,59,214,215,61,257,274,120,294,242,276,337,285,335,322
Croatia,HR,HRV,Europe,2018,5052,2679,626,1395,1532,273,1901,2158,899,2065,1503,1805,2571,2009,2431,2173
Croatia,HR,HRV,Europe,2017,5335,3186,826,1858,1625,392,2360,2451,1218,2513,2029,2017,3015,2531,2843,2684
Croatia,HR,HRV,Europe,2016,4518,2653,671,1614,1298,313,2079,1969,984,2046,1756,1611,2511,2221,2282,2188
Croatia,HR,HRV,Europe,2015,3664,2039,418,1290,1006,317,1570,1424,735,1605,1444,1323,1885,1724,1741,1759
Croatia,HR,HRV,Europe,2014,3362,1761,439,1152,721,266,1446,1160,705,1331,1289,987,1625,1583,1426,1468
Croatia,HR,HRV,Europe,2013,3221,1512,405,971,541,254,1241,946,659,1129,1084,795,1399,1354,1200,1242
Croatia,HR,HRV,Europe,2012,2914,1383,385,965,430,261,1178,815,646,1072,1064,691,1285,1277,1076,1171
Croatia,HR,HRV,Europe,2011,2668,1141,285,772,348,235,944,633,520,861,880,583,1033,1052,868,969
Croatia,HR,HRV,Europe,2010,2191,885,293,575,228,147,729,521,440,654,652,375,808,806,668,731
Croatia,HR,HRV,Europe,2009,2021,721,254,434,161,117,585,415,371,504,500,278,655,651,532,570
Czechia,CZ,CZE,Europe,2019,3318,1172,111,774,682,238,867,793,349,958,895,920,1051,988,1031,1079
Czechia,CZ,CZE,Europe,2018,18464,8013,2127,4409,3649,1231,6255,5776,3358,5610,4966,4880,7456,6812,7007,6167
Czechia,CZ,CZE,Europe,2017,18399,8329,1759,4856,3437,1771,6073,5196,3530,6127,5843,5208,7344,7060,6967,7114
Czechia,CZ,CZE,Europe,2016,17825,8352,1973,4832,3233,1782,6145,5206,3755,6022,5850,5015,7335,7163,6988,7040
Czechia,CZ,CZE,Europe,2015,16482,7516,1603,4150,2896,1839,5176,4499,3442,5295,5345,4735,6321,6371,6338,6490
Czechia,CZ,CZE,Europe,2014,16322,7383,1636,3666,3078,1562,4714,4714,3198,5269,4732,4640,6317,5780,6276,6335
Czechia,CZ,CZE,Europe,2013,14269,6107,1638,3203,2119,1314,4268,3757,2952,4212,4034,3433,5277,5099,5071,5043
Czechia,CZ,CZE,Europe,2012,12229,5051,1618,2790,1280,1310,3836,2898,2928,3234,3561,2590,4280,4607,4208,4005
Czechia,CZ,CZE,Europe,2011,10944,4035,1450,2270,866,922,3203,2316,2372,2592,2780,1788,3525,3713,3238,3102
Czechia,CZ,CZE,Europe,2010,10561,3478,1385,2003,540,653,2879,1925,2038,2189,2416,1193,3065,3292,2578,2602
Czechia,CZ,CZE,Europe,2009,9408,2865,1156,1684,390,520,2413,1546,1676,1814,2006,910,2543,2735,2066,2136
Denmark,DK,DNK,Europe,2103,1,1,0,1,0,0,1,0,0,1,1,0,1,1,0,1
Denmark,DK,DNK,Europe,2019,5536,1933,139,1440,1021,463,1529,1160,602,1628,1656,1484,1717,1745,1623,1844
Denmark,DK,DNK,Europe,2018,26480,10673,1217,8912,5009,2105,9581,6226,3322,9547,9370,7114,10216,10039,8331,10005
Denmark,DK,DNK,Europe,2017,27667,14219,2754,11497,4687,2510,13134,7441,5264,11911,12168,7197,13548,13805,9951,12582
Denmark,DK,DNK,Europe,2016,25098,13492,2871,10804,4163,2338,12344,7034,5209,11226,11531,6501,12766,13071,9372,11953
Denmark,DK,DNK,Europe,2015,23835,12500,2995,9646,3670,2233,11247,6665,5228,9996,10549,5903,11597,12150,8898,10899
Denmark,DK,DNK,Europe,2014,22428,11020,3022,8243,3066,1841,9904,6088,4863,8582,9020,4907,10243,10681,7929,9359
Denmark,DK,DNK,Europe,2013,20824,9755,2798,7126,2542,1508,8798,5340,4306,7391,7818,4050,9063,9490,6848,8083
Denmark,DK,DNK,Europe,2012,18991,8518,2652,6260,1992,1218,7765,4644,3870,6509,6764,3210,8014,8269,5862,7013
Denmark,DK,DNK,Europe,2011,17270,7313,2565,5130,1510,1004,6585,4075,3569,5383,5605,2514,6838,7060,5079,5858
Denmark,DK,DNK,Europe,2010,15930,6677,2559,4493,1161,774,5983,3720,3333,4788,4892,1935,6278,6382,4494,5187
Denmark,DK,DNK,Europe,2009,20591,6516,2561,4273,933,655,5877,3494,3216,4601,4584,1588,6205,6188,4149,4912
Estonia,EE,EST,Europe,2019,657,215,11,157,143,44,166,154,55,190,173,187,199,182,198,206
Estonia,EE,EST,Europe,2018,3092,1240,131,856,683,255,951,814,386,1059,942,938,1154,1037,1069,1145
Estonia,EE,EST,Europe,2017,3204,1475,280,952,679,296,1125,959,576,1178,1076,975,1351,1249,1255,1302
Estonia,EE,EST,Europe,2016,3042,1372,304,900,560,260,1083,864,564,1084,1005,820,1267,1188,1124,1189
Estonia,EE,EST,Europe,2015,2899,1259,286,783,513,242,954,799,528,958,913,755,1129,1084,1041,1088
Estonia,EE,EST,Europe,2014,2940,1282,309,757,517,268,954,826,577,943,899,785,1140,1096,1094,1085
Estonia,EE,EST,Europe,2013,2762,1122,310,621,388,237,842,698,547,797,725,625,1018,946,935,901
Estonia,EE,EST,Europe,2012,2446,1003,346,530,279,242,783,625,588,659,621,521,912,874,867,750
Estonia,EE,EST,Europe,2011,2156,779,262,436,221,178,605,483,440,528,519,399,697,688,661,611
Estonia,EE,EST,Europe,2010,2071,716,266,421,196,108,563,462,374,511,484,304,653,626,570,574
Estonia,EE,EST,Europe,2009,1793,542,207,280,149,69,421,356,276,354,327,218,495,468,425,401
Faroe Islands,FO,FRO,Europe,2019,18,7,0,5,6,0,5,6,0,7,5,6,7,5,6,7
Faroe Islands,FO,FRO,Europe,2018,59,32,5,20,16,5,24,21,10,24,24,21,28,28,26,28
Faroe Islands,FO,FRO,Europe,2017,51,34,5,31,12,3,32,17,8,32,32,15,33,33,20,33
Faroe Islands,FO,FRO,Europe,2016,38,25,7,21,8,1,24,15,8,22,21,9,25,24,16,22
Faroe Islands,FO,FRO,Europe,2015,52,28,4,23,8,1,26,12,5,24,24,9,27,27,13,25
Faroe Islands,FO,FRO,Europe,2014,24,16,3,12,4,4,13,7,7,14,13,8,15,14,11,15
Faroe Islands,FO,FRO,Europe,2013,12,9,0,9,2,2,9,2,2,9,9,4,9,9,4,9
Faroe Islands,FO,FRO,Europe,2012,21,10,1,9,2,3,9,3,4,9,10,5,9,10,6,10
Faroe Islands,FO,FRO,Europe,2011,18,17,5,14,1,2,16,6,7,15,14,3,17,16,8,15
Faroe Islands,FO,FRO,Europe,2010,17,11,2,10,0,1,10,2,3,10,11,1,10,11,3,11
Faroe Islands,FO,FRO,Europe,2009,9,2,0,2,0,0,2,0,0,2,2,0,2,2,0,2
Finland,FI,FIN,Europe,2020,1,1,0,1,1,0,1,1,0,1,1,1,1,1,1,1
Finland,FI,FIN,Europe,2019,4039,1620,126,1064,753,551,1149,879,677,1234,1365,1304,1319,1450,1430,1535
Finland,FI,FIN,Europe,2018,20327,8473,759,6723,3937,2088,7137,4696,2847,7445,7338,6025,7859,7752,6784,8060
Finland,FI,FIN,Europe,2017,21231,10455,1901,8201,3557,2006,9283,5458,3907,8738,8836,5563,9820,9918,7464,9373
Finland,FI,FIN,Europe,2016,19797,9672,1864,7426,3038,2046,8468,4902,3910,7892,8164,5084,8934,9206,6948,8630
Finland,FI,FIN,Europe,2015,18773,8381,1943,6174,2628,1717,7280,4571,3660,6547,6903,4345,7653,8009,6288,7276
Finland,FI,FIN,Europe,2014,17970,7691,1944,5541,2380,1388,6623,4324,3332,5945,6207,3768,7027,7289,5712,6611
Finland,FI,FIN,Europe,2013,17216,6727,1992,4625,1874,1207,5814,3866,3199,4966,5198,3081,6155,6387,5073,5539
Finland,FI,FIN,Europe,2012,16127,6211,1990,4177,1634,1145,5362,3624,3135,4504,4701,2779,5689,5886,4769,5028
Finland,FI,FIN,Europe,2011,15171,5554,2021,3616,1221,901,4855,3242,2922,3876,4055,2122,5115,5294,4143,4315
Finland,FI,FIN,Europe,2010,14846,5033,1963,3193,954,696,4390,2917,2659,3479,3551,1650,4676,4748,3613,3837
Finland,FI,FIN,Europe,2009,16838,4733,1898,2846,866,642,4025,2764,2540,3224,3177,1508,4403,4356,3406,3555
France,FR,FRA,Europe,2099,2,2,0,0,2,0,0,2,0,2,0,2,2,0,2,2
France,FR,FRA,Europe,2048,1,0,0,0,0,0,0,0,0,0,0,0,0,0,0,0
France,FR,FRA,Europe,2019,18394,6037,368,4402,3174,1127,4662,3542,1495,5162,5017,4301,5422,5277,4669,5777
France,FR,FRA,Europe,2018,91617,33928,3247,27146,14532,5474,29010,17779,8721,30038,29172,20006,31902,31036,23253,32064
France,FR,FRA,Europe,2017,99242,43515,8322,33568,13649,6884,38302,21971,15206,35952,36399,20533,40686,41133,28855,38783
France,FR,FRA,Europe,2016,94011,42608,8855,32091,12178,7836,36748,21033,16691,34189,35857,20014,38846,40514,28869,37955
France,FR,FRA,Europe,2015,90108,40078,9183,29570,10883,7660,34336,20066,16843,31284,33601,18543,36050,38367,27726,35315
France,FR,FRA,Europe,2014,90852,38682,10145,28059,9702,6640,33281,19847,16785,29625,31898,16342,34847,37120,26487,33464
France,FR,FRA,Europe,2013,88316,36482,10317,26181,8476,6246,31645,18793,16563,27529,29671,14722,32993,35135,25039,31019
France,FR,FRA,Europe,2012,83551,33626,11035,23691,6762,5736,29330,17797,16771,24829,26855,12498,30468,32494,23533,27993
France,FR,FRA,Europe,2011,78673,30392,10515,21142,5381,4990,26683,15896,15505,22096,23899,10371,27637,29440,20886,24853
France,FR,FRA,Europe,2010,77473,28122,10628,19466,4277,3808,24938,14905,14436,20487,21632,8085,25959,27104,18713,22653
France,FR,FRA,Europe,2009,73761,25723,10098,17315,3271,3611,22793,13369,13709,18085,19479,6882,23563,24957,16980,20249
Germany,DE,DEU,Europe,2104,1,1,1,1,0,0,1,1,1,1,1,0,1,1,1,1
Germany,DE,DEU,Europe,2040,1,1,0,1,0,0,1,0,0,1,1,0,1,1,0,1
Germany,DE,DEU,Europe,2039,1,1,0,1,0,0,1,0,0,1,1,0,1,1,0,1
Germany,DE,DEU,Europe,2038,1,0,0,0,0,0,0,0,0,0,0,0,0,0,0,0
Germany,DE,DEU,Europe,2035,1,1,0,1,0,0,1,0,0,1,1,0,1,1,0,1
Germany,DE,DEU,Europe,2034,1,0,0,0,0,0,0,0,0,0,0,0,0,0,0,0
Germany,DE,DEU,Europe,2033,1,1,0,1,0,0,1,0,0,1,1,0,1,1,0,1
Germany,DE,DEU,Europe,2032,1,1,0,1,0,0,1,0,0,1,1,0,1,1,0,1
Germany,DE,DEU,Europe,2031,1,1,0,1,0,0,1,0,0,1,1,0,1,1,0,1
Germany,DE,DEU,Europe,2030,1,0,0,0,0,0,0,0,0,0,0,0,0,0,0,0
Germany,DE,DEU,Europe,2029,1,1,0,1,0,0,1,0,0,1,1,0,1,1,0,1
Germany,DE,DEU,Europe,2026,1,1,0,1,0,0,1,0,0,1,1,0,1,1,0,1
Germany,DE,DEU,Europe,2025,2,1,0,1,0,0,1,0,0,1,1,0,1,1,0,1
Germany,DE,DEU,Europe,2024,1,1,0,1,0,0,1,0,0,1,1,0,1,1,0,1
Germany,DE,DEU,Europe,2023,1,1,0,1,0,0,1,0,0,1,1,0,1,1,0,1
Germany,DE,DEU,Europe,2022,1,0,0,0,0,0,0,0,0,0,0,0,0,0,0,0
Germany,DE,DEU,Europe,2021,1,0,0,0,0,0,0,0,0,0,0,0,0,0,0,0
Germany,DE,DEU,Europe,2020,1,1,0,1,0,0,1,0,0,1,1,0,1,1,0,1
Germany,DE,DEU,Europe,2019,28081,10063,820,6952,5220,2286,7579,6040,3106,8123,8265,7506,8750,8892,8326,9436
Germany,DE,DEU,Europe,2018,139644,53088,5556,40847,24902,10563,44460,30458,16119,45390,44936,35465,49003,48549,41021,49479
Germany,DE,DEU,Europe,2017,146422,64532,13907,47063,22793,12391,55748,36700,26298,50793,52126,35184,59478,60811,49091,55856
Germany,DE,DEU,Europe,2016,138096,62462,13652,45446,19792,13398,53167,33444,27050,48685,51508,33190,56406,59229,46842,54747
Germany,DE,DEU,Europe,2015,133412,58558,14093,42270,18111,12039,50075,32204,26132,44886,48140,30150,52691,55945,44243,50756
Germany,DE,DEU,Europe,2014,131005,54529,15203,38593,15269,10403,46928,30472,25606,40753,44036,25672,49088,52371,40875,46196
Germany,DE,DEU,Europe,2013,128068,50988,16147,35756,13036,8117,44932,29183,24264,37630,39938,21153,46806,49114,37300,41812
Germany,DE,DEU,Europe,2012,122476,47125,16631,32279,10445,7842,41496,27076,24473,33910,36280,18287,43127,45497,34918,37911
Germany,DE,DEU,Europe,2011,115458,41508,15484,28244,7677,6699,36692,23161,22183,29595,31710,14376,38043,40158,29860,33061
Germany,DE,DEU,Europe,2010,121794,39250,16109,25661,6279,5145,34782,22388,21254,27309,28483,11424,36430,37604,27533,30131
Germany,DE,DEU,Europe,2009,110864,35625,15538,23039,4742,4657,31954,20280,20195,24244,25510,9399,33159,34425,24937,26715
Gibraltar,GI,GIB,Europe,2019,4,0,0,0,0,0,0,0,0,0,0,0,0,0,0,0
Gibraltar,GI,GIB,Europe,2018,8,4,1,3,3,0,3,4,1,4,3,3,4,3,4,4
Gibraltar,GI,GIB,Europe,2017,12,3,1,2,1,0,3,2,1,2,2,1,3,3,2,2
Gibraltar,GI,GIB,Europe,2016,16,2,0,2,1,0,2,1,0,2,2,1,2,2,1,2
Gibraltar,GI,GIB,Europe,2015,3,2,0,1,2,0,1,2,0,2,1,2,2,1,2,2
Gibraltar,GI,GIB,Europe,2014,12,6,1,6,4,0,6,5,1,6,6,4,6,6,5,6
Gibraltar,GI,GIB,Europe,2013,15,7,1,6,3,2,6,4,3,6,7,5,6,7,6,7
Gibraltar,GI,GIB,Europe,2012,12,3,0,3,2,0,3,2,0,3,3,2,3,3,2,3
Gibraltar,GI,GIB,Europe,2011,12,3,1,3,1,0,3,2,1,3,3,1,3,3,2,3
Gibraltar,GI,GIB,Europe,2010,4,1,1,0,0,0,1,1,1,0,0,0,1,1,1,0
Gibraltar,GI,GIB,Europe,2009,3,0,0,0,0,0,0,0,0,0,0,0,0,0,0,0
Greece,GR,GRC,Europe,2114,1,1,0,0,1,0,0,1,0,1,0,1,1,0,1,1
Greece,GR,GRC,Europe,2019,3123,1024,79,644,633,219,703,712,298,854,756,852,913,815,931,966
Greece,GR,GRC,Europe,2018,15178,5514,554,3562,3007,1166,3955,3561,1720,4507,4176,4173,4900,4569,4727,5121
Greece,GR,GRC,Europe,2017,16066,6798,1214,4006,2547,1758,4856,3761,2972,4822,5133,4305,5672,5983,5519,5949
Greece,GR,GRC,Europe,2016,14565,6214,1217,3899,2125,1519,4690,3342,2736,4548,4775,3644,5339,5566,4861,5424
Greece,GR,GRC,Europe,2015,13105,5305,1153,3429,1766,1324,4169,2919,2477,3811,4183,3090,4551,4923,4243,4565
Greece,GR,GRC,Europe,2014,13443,4983,1199,3061,1608,1162,3872,2807,2361,3472,3761,2770,4283,4572,3969,4172
Greece,GR,GRC,Europe,2013,13386,4702,1378,2737,1217,1170,3720,2595,2548,3004,3453,2387,3987,4436,3765,3720
Greece,GR,GRC,Europe,2012,12361,4257,1260,2540,1072,1098,3408,2332,2358,2791,3138,2170,3659,4006,3430,3389
Greece,GR,GRC,Europe,2011,12552,3856,1268,2240,898,890,3160,2166,2158,2448,2728,1788,3368,3648,3056,2936
Greece,GR,GRC,Europe,2010,12137,3501,1276,1987,789,590,2893,2065,1866,2205,2378,1379,3111,3284,2655,2596
Greece,GR,GRC,Europe,2009,11905,3075,1165,1830,559,524,2639,1724,1689,2014,2082,1083,2823,2891,2248,2266
Hungary,HU,HUN,Europe,2019,1811,775,69,529,362,197,573,431,266,616,644,559,660,688,628,731
Hungary,HU,HUN,Europe,2018,9723,4576,623,3565,1905,828,3891,2528,1451,4002,3813,2733,4328,4139,3356,4250
Hungary,HU,HUN,Europe,2017,9640,5477,1019,4275,1610,919,4799,2629,1938,4625,4604,2529,5149,5128,3548,4954
Hungary,HU,HUN,Europe,2016,9059,5415,966,4281,1464,912,4763,2430,1878,4596,4618,2376,5078,5100,3342,4933
Hungary,HU,HUN,Europe,2015,8595,4898,883,3742,1351,844,4208,2234,1727,4051,4123,2195,4517,4589,3078,4432
Hungary,HU,HUN,Europe,2014,8488,4542,1036,3405,1054,771,3974,2090,1807,3620,3758,1825,4189,4327,2861,3973
Hungary,HU,HUN,Europe,2013,7854,3712,876,2708,837,688,3182,1713,1564,2910,3036,1525,3384,3510,2401,3238
Hungary,HU,HUN,Europe,2012,7617,3138,929,2120,625,679,2656,1554,1608,2288,2434,1304,2824,2970,2233,2602
Hungary,HU,HUN,Europe,2011,7185,2740,836,1849,441,576,2320,1277,1412,1974,2144,1017,2445,2615,1853,2269
Hungary,HU,HUN,Europe,2010,6932,2419,908,1493,363,404,2055,1271,1312,1628,1722,767,2190,2284,1675,1857
Hungary,HU,HUN,Europe,2009,6859,2197,853,1368,257,347,1887,1110,1200,1479,1567,604,1998,2086,1457,1678
Iceland,IS,ISL,Europe,2019,290,97,5,68,55,19,72,60,24,83,78,74,87,82,79,93
Iceland,IS,ISL,Europe,2018,1335,597,48,504,277,128,517,325,176,545,543,405,558,556,453,584
Iceland,IS,ISL,Europe,2017,1418,739,131,593,253,143,658,384,274,634,633,396,699,698,527,674
Iceland,IS,ISL,Europe,2016,1237,648,108,516,216,134,565,324,242,548,567,350,597,616,458,599
Iceland,IS,ISL,Europe,2015,1182,602,137,469,170,105,528,307,242,495,517,275,554,576,412,543
Iceland,IS,ISL,Europe,2014,1088,531,122,396,152,99,448,274,221,435,440,251,487,492,373,479
Iceland,IS,ISL,Europe,2013,1091,494,145,368,131,68,438,276,213,385,407,199,455,477,344,424
Iceland,IS,ISL,Europe,2012,1046,484,169,354,108,62,430,277,231,384,378,170,460,454,339,408
Iceland,IS,ISL,Europe,2011,943,413,164,304,82,54,376,246,218,322,323,136,394,395,300,341
Iceland,IS,ISL,Europe,2010,954,377,139,263,68,45,337,207,184,280,286,113,354,360,252,303
Iceland,IS,ISL,Europe,2009,790,288,131,187,40,30,265,171,161,196,202,70,274,280,201,211
Ireland,IE,IRL,Europe,2107,1,1,1,0,0,0,1,1,1,0,0,0,1,1,1,0
Ireland,IE,IRL,Europe,2019,3058,966,87,698,529,229,753,616,316,815,794,758,870,849,845,911
Ireland,IE,IRL,Europe,2018,14846,5275,495,4253,2582,1091,4551,3077,1586,4664,4566,3673,4962,4864,4168,4977
Ireland,IE,IRL,Europe,2017,15059,6961,1384,5280,2516,1169,6169,3900,2553,5722,5631,3685,6611,6520,5069,6073
Ireland,IE,IRL,Europe,2016,13602,6460,1401,4969,1905,1242,5805,3306,2643,5191,5403,3147,6027,6239,4548,5625
Ireland,IE,IRL,Europe,2015,12642,5939,1226,4578,1770,1202,5287,2996,2428,4751,5057,2972,5460,5766,4198,5230
Ireland,IE,IRL,Europe,2014,12259,5446,1335,4201,1293,966,4923,2628,2301,4322,4603,2259,5044,5325,3594,4724
Ireland,IE,IRL,Europe,2013,12123,5266,1376,4026,1136,856,4803,2512,2232,4157,4360,1992,4934,5137,3368,4491
Ireland,IE,IRL,Europe,2012,11400,4770,1308,3584,867,879,4314,2175,2187,3682,3943,1746,4412,4673,3054,4041
Ireland,IE,IRL,Europe,2011,11226,4522,1406,3419,698,679,4176,2104,2085,3501,3683,1377,4258,4440,2783,3765
Ireland,IE,IRL,Europe,2010,10648,4103,1560,2916,525,407,3812,2085,1967,3018,3105,932,3914,4001,2492,3207
Ireland,IE,IRL,Europe,2009,9568,3474,1249,2502,418,369,3231,1667,1618,2573,2674,787,3302,3403,2036,2745
Italy,IT,ITA,Europe,2023,1,0,0,0,0,0,0,0,0,0,0,0,0,0,0,0
Italy,IT,ITA,Europe,2019,19785,6779,505,4835,4181,1096,5199,4686,1601,5814,5437,5277,6178,5801,5782,6416
Italy,IT,ITA,Europe,2018,93918,34308,3336,26211,18064,5699,28310,21400,9035,30054,28368,23763,32153,30467,27099,32211
Italy,IT,ITA,Europe,2017,98202,42206,8051,30812,15820,7575,35901,23871,15626,34009,33922,23395,39098,39011,31446,37119
Italy,IT,ITA,Europe,2016,89695,39440,8207,28610,12956,7871,33522,21163,16078,30980,32162,20827,35892,37074,29034,34532
Italy,IT,ITA,Europe,2015,83907,36601,8331,26207,11832,7399,31124,20163,15730,28078,29816,19231,32995,34733,27562,31687
Italy,IT,ITA,Europe,2014,82233,33860,8539,23600,10432,6717,28449,18971,15256,25347,27266,17149,30196,32115,25688,29013
Italy,IT,ITA,Europe,2013,77952,30497,8770,20482,8663,5478,25819,17433,14248,22218,23425,14141,27555,28762,22911,25161
Italy,IT,ITA,Europe,2012,69881,26192,8479,17330,6445,4712,22246,14924,13191,18768,19840,11157,23684,24756,19636,21278
Italy,IT,ITA,Europe,2011,66309,22991,8173,14768,4854,3710,19672,13027,11883,16059,16796,8564,20963,21700,16737,18087
Italy,IT,ITA,Europe,2010,64062,21548,8307,13405,4439,2921,18249,12746,11228,14962,15150,7360,19806,19994,15667,16707
Italy,IT,ITA,Europe,2009,61161,18779,7900,11658,2727,2656,16427,10627,10556,12490,13178,5383,17259,17947,13283,14010
Jersey,JE,JEY,Europe,2019,7,2,0,2,1,1,2,1,1,2,2,2,2,2,2,2
Jersey,JE,JEY,Europe,2018,20,9,0,9,5,3,9,5,3,9,9,8,9,9,8,9
Jersey,JE,JEY,Europe,2017,25,11,2,10,4,1,10,6,3,11,10,5,11,10,7,11
Jersey,JE,JEY,Europe,2016,26,10,1,7,4,1,8,5,2,8,8,5,9,9,6,9
Jersey,JE,JEY,Europe,2015,22,12,4,6,2,2,10,6,6,7,7,4,11,11,8,8
Jersey,JE,JEY,Europe,2014,30,13,3,9,5,3,12,8,6,9,10,8,12,13,11,10
Jersey,JE,JEY,Europe,2013,30,12,6,4,0,2,10,6,8,4,6,2,10,12,8,6
Jersey,JE,JEY,Europe,2012,29,9,4,5,1,1,8,5,5,5,6,2,8,9,6,6
Jersey,JE,JEY,Europe,2011,23,10,5,3,3,2,7,8,7,5,4,5,9,8,10,6
Jersey,JE,JEY,Europe,2010,23,9,6,5,2,0,9,8,6,5,5,2,9,9,8,5
Jersey,JE,JEY,Europe,2009,19,10,9,3,0,0,10,9,9,3,3,0,10,10,9,3
Latvia,LV,LVA,Europe,2019,327,130,10,56,66,48,65,76,58,84,93,114,93,102,124,121
Latvia,LV,LVA,Europe,2018,1645,578,48,283,355,140,318,403,188,447,379,495,482,414,543,543
Latvia,LV,LVA,Europe,2017,1879,854,74,299,328,379,362,402,453,474,616,707,537,679,781,791
Latvia,LV,LVA,Europe,2016,1781,691,107,250,236,242,340,343,349,398,453,478,488,543,585,601
Latvia,LV,LVA,Europe,2015,2000,726,121,226,231,288,309,352,409,384,485,519,467,568,640,643
Latvia,LV,LVA,Europe,2014,1503,582,151,214,201,170,329,352,321,323,358,371,438,473,522,467
Latvia,LV,LVA,Europe,2013,1397,474,117,158,139,159,247,256,276,249,294,298,338,383,415,385
Latvia,LV,LVA,Europe,2012,1309,389,124,129,122,91,223,246,215,219,205,213,313,299,337,295
Latvia,LV,LVA,Europe,2011,1208,350,169,118,60,64,251,229,233,158,177,124,291,310,293,217
Latvia,LV,LVA,Europe,2010,1015,240,107,135,54,25,178,161,132,175,157,79,218,200,186,197
Latvia,LV,LVA,Europe,2009,1043,254,112,122,49,26,199,161,138,156,143,75,233,220,187,177
Liechtenstein,LI,LIE,Europe,2019,5,0,0,0,0,0,0,0,0,0,0,0,0,0,0,0
Liechtenstein,LI,LIE,Europe,2018,42,9,3,6,4,1,8,7,4,7,6,5,9,8,8,7
Liechtenstein,LI,LIE,Europe,2017,57,13,3,8,2,3,11,5,6,8,10,5,11,13,8,10
Liechtenstein,LI,LIE,Europe,2016,42,11,4,8,3,1,11,7,5,8,8,4,11,11,8,8
Liechtenstein,LI,LIE,Europe,2015,21,8,3,5,1,2,6,4,5,5,7,3,6,8,6,7
Liechtenstein,LI,LIE,Europe,2014,49,7,4,4,2,0,6,6,4,5,4,2,7,6,6,5
Liechtenstein,LI,LIE,Europe,2013,45,14,5,9,1,1,13,6,6,9,10,2,13,14,7,10
Liechtenstein,LI,LIE,Europe,2012,22,4,3,2,0,0,4,3,3,2,2,0,4,4,3,2
Liechtenstein,LI,LIE,Europe,2011,28,3,1,1,0,2,2,1,3,1,2,2,2,3,3,2
Liechtenstein,LI,LIE,Europe,2010,24,6,4,2,0,0,6,4,4,2,2,0,6,6,4,2
Liechtenstein,LI,LIE,Europe,2009,10,2,1,2,0,0,2,1,1,2,2,0,2,2,1,2
Lithuania,LT,LTU,Europe,2019,643,288,22,159,219,34,172,241,56,260,174,253,273,187,275,275
Lithuania,LT,LTU,Europe,2018,3032,1436,189,696,978,194,844,1167,383,1184,800,1172,1332,948,1361,1288
Lithuania,LT,LTU,Europe,2017,3253,1639,267,691,801,403,895,1068,670,1121,1005,1204,1325,1209,1471,1435
Lithuania,LT,LTU,Europe,2016,2946,1612,343,709,757,329,969,1100,672,1129,932,1086,1389,1192,1429,1352
Lithuania,LT,LTU,Europe,2015,3195,1672,314,618,768,466,866,1082,780,1046,996,1234,1294,1244,1548,1424
Lithuania,LT,LTU,Europe,2014,2908,1518,295,510,680,452,746,975,747,913,879,1132,1149,1115,1427,1282
Lithuania,LT,LTU,Europe,2013,2531,1189,232,367,477,386,558,709,618,703,662,863,894,853,1095,998
Lithuania,LT,LTU,Europe,2012,2239,914,193,365,347,294,507,540,487,580,557,641,722,699,834,772
Lithuania,LT,LTU,Europe,2011,2051,883,159,272,388,251,393,547,410,573,461,639,694,582,798,762
Lithuania,LT,LTU,Europe,2010,1430,626,124,267,280,165,342,404,289,411,408,445,486,483,569,552
Lithuania,LT,LTU,Europe,2009,1414,584,150,219,268,119,343,418,269,357,322,387,481,446,537,460
Luxembourg,LU,LUX,Europe,2019,214,99,5,88,42,24,91,47,29,93,91,66,96,94,71,96
Luxembourg,LU,LUX,Europe,2018,1088,570,36,510,192,100,527,228,136,531,532,292,548,549,328,553
Luxembourg,LU,LUX,Europe,2017,1052,620,61,545,160,119,574,221,180,560,576,279,589,605,340,591
Luxembourg,LU,LUX,Europe,2016,976,558,60,492,148,79,521,208,139,510,511,227,539,540,287,529
Luxembourg,LU,LUX,Europe,2015,1004,587,59,512,165,82,544,224,141,529,538,247,561,570,306,555
Luxembourg,LU,LUX,Europe,2014,961,505,80,431,116,67,470,196,147,443,454,183,482,493,263,466
Luxembourg,LU,LUX,Europe,2013,908,487,80,423,116,61,461,196,141,438,434,177,476,472,257,449
Luxembourg,LU,LUX,Europe,2012,687,336,65,283,72,45,310,137,110,292,300,117,319,327,182,309
Luxembourg,LU,LUX,Europe,2011,615,302,59,241,55,57,273,114,116,247,264,112,279,296,171,270
Luxembourg,LU,LUX,Europe,2010,555,282,68,211,58,42,248,126,110,233,223,100,270,260,168,245
Luxembourg,LU,LUX,Europe,2009,488,222,42,164,30,41,192,72,83,178,180,71,206,208,113,194
Macedonia,MK,MKD,Europe,2019,35,13,2,8,5,4,10,7,6,8,11,9,10,13,11,11
Macedonia,MK,MKD,Europe,2018,182,89,11,48,47,22,58,58,33,66,61,69,76,71,80,79
Macedonia,MK,MKD,Europe,2017,250,148,18,56,76,33,72,94,51,103,85,109,119,101,127,132
Macedonia,MK,MKD,Europe,2016,214,122,31,58,32,36,82,63,67,71,85,68,95,109,99,98
Macedonia,MK,MKD,Europe,2015,222,132,24,47,42,54,65,66,78,69,92,96,87,110,120,114
Macedonia,MK,MKD,Europe,2014,169,98,19,49,31,33,62,50,52,62,72,64,75,85,83,85
Macedonia,MK,MKD,Europe,2013,152,82,20,33,12,29,50,32,49,38,60,41,55,77,61,65
Macedonia,MK,MKD,Europe,2012,127,66,9,37,22,22,42,31,31,42,56,44,47,61,53,61
Macedonia,MK,MKD,Europe,2011,92,35,6,19,7,10,25,13,16,21,27,17,27,33,23,29
Macedonia,MK,MKD,Europe,2010,87,23,4,13,8,5,15,12,9,17,17,13,19,19,17,21
Macedonia,MK,MKD,Europe,2009,70,17,0,13,6,2,13,6,2,15,15,8,15,15,8,17
Malta,MT,MLT,Europe,2019,132,32,6,16,17,5,21,23,11,26,17,22,31,22,28,27
Malta,MT,MLT,Europe,2018,693,234,35,156,108,52,180,143,87,190,176,160,214,200,195,210
Malta,MT,MLT,Europe,2017,644,294,62,192,120,47,235,182,109,226,217,167,269,260,229,251
Malta,MT,MLT,Europe,2016,608,264,66,179,92,41,223,158,107,201,198,133,245,242,199,220
Malta,MT,MLT,Europe,2015,469,213,52,150,81,35,175,133,87,169,169,116,194,194,168,188
Malta,MT,MLT,Europe,2014,459,188,62,117,56,38,149,118,100,132,141,94,164,173,156,156
Malta,MT,MLT,Europe,2013,382,141,47,81,44,25,115,91,72,92,96,69,126,130,116,107
Malta,MT,MLT,Europe,2012,332,118,35,66,40,22,92,75,57,79,79,62,105,105,97,92
Malta,MT,MLT,Europe,2011,239,73,30,44,18,10,64,48,40,48,49,28,68,69,58,53
Malta,MT,MLT,Europe,2010,199,74,32,36,17,9,59,49,41,44,43,26,67,66,58,51
Malta,MT,MLT,Europe,2009,162,40,9,18,13,7,25,22,16,28,23,20,35,30,29,33
Moldova,MD,MDA,Europe,2019,26,9,1,4,7,1,5,8,2,8,4,8,9,5,9,8
Moldova,MD,MDA,Europe,2018,182,58,7,23,34,10,28,41,17,46,30,44,51,35,51,53
Moldova,MD,MDA,Europe,2017,176,58,7,33,30,11,38,37,18,45,41,41,50,46,48,53
Moldova,MD,MDA,Europe,2016,210,78,4,45,33,22,49,37,26,60,59,55,64,63,59,74
Moldova,MD,MDA,Europe,2015,189,68,6,31,32,18,36,38,24,52,42,50,57,47,56,63
Moldova,MD,MDA,Europe,2014,217,57,5,23,19,19,26,24,24,37,40,38,40,43,43,54
Moldova,MD,MDA,Europe,2013,201,52,4,28,25,6,32,29,10,43,33,31,47,37,35,48
Moldova,MD,MDA,Europe,2012,179,29,12,15,6,2,27,18,14,15,17,8,27,29,20,17
Moldova,MD,MDA,Europe,2011,187,27,12,14,2,5,26,14,17,14,15,7,26,27,19,15
Moldova,MD,MDA,Europe,2010,174,24,7,12,4,3,19,11,10,14,15,7,21,22,14,17
Moldova,MD,MDA,Europe,2009,203,26,8,15,5,3,22,13,11,16,18,8,23,25,16,19
Monaco,MC,MCO,Europe,2019,11,3,0,1,3,0,1,3,0,3,1,3,3,1,3,3
Monaco,MC,MCO,Europe,2018,25,2,1,1,1,0,2,2,1,1,1,1,2,2,2,1
Monaco,MC,MCO,Europe,2017,27,6,3,2,1,0,5,4,3,3,2,1,6,5,4,3
Monaco,MC,MCO,Europe,2016,22,10,8,0,1,1,8,9,9,1,1,2,9,9,10,2
Monaco,MC,MCO,Europe,2015,12,2,0,2,1,0,2,1,0,2,2,1,2,2,1,2
Monaco,MC,MCO,Europe,2014,8,3,0,1,0,2,1,0,2,1,3,2,1,3,2,3
Monaco,MC,MCO,Europe,2013,12,7,3,2,2,1,5,5,4,3,3,3,6,6,6,4
Monaco,MC,MCO,Europe,2012,11,6,1,2,1,3,2,2,4,3,5,4,3,5,5,6
Monaco,MC,MCO,Europe,2011,3,0,0,0,0,0,0,0,0,0,0,0,0,0,0,0
Monaco,MC,MCO,Europe,2010,5,2,0,0,0,2,0,0,2,0,2,2,0,2,2,2
Monaco,MC,MCO,Europe,2009,8,2,0,2,1,0,2,1,0,2,2,1,2,2,1,2
Montenegro,ME,MNE,Europe,2019,78,37,4,15,24,4,19,28,8,30,18,28,34,22,32,33
Montenegro,ME,MNE,Europe,2018,484,201,28,80,137,20,103,165,48,166,92,157,189,115,185,178
Montenegro,ME,MNE,Europe,2017,480,225,30,100,138,30,124,168,60,180,121,168,204,145,198,201
Montenegro,ME,MNE,Europe,2016,439,214,31,79,114,50,104,145,81,148,120,164,173,145,195,189
Montenegro,ME,MNE,Europe,2015,360,163,23,64,83,37,82,106,60,113,96,120,131,114,143,145
Montenegro,ME,MNE,Europe,2014,307,144,20,76,78,33,92,98,53,107,97,111,123,113,131,128
Montenegro,ME,MNE,Europe,2013,331,163,22,97,57,65,116,79,87,122,119,122,141,138,144,144
Montenegro,ME,MNE,Europe,2012,266,147,20,93,51,61,107,71,81,120,106,112,134,120,132,133
Montenegro,ME,MNE,Europe,2011,216,85,14,52,22,36,63,36,50,64,62,58,75,73,72,74
Montenegro,ME,MNE,Europe,2010,214,71,15,34,25,21,44,40,36,52,43,46,62,53,61,61
Montenegro,ME,MNE,Europe,2009,154,62,6,43,14,21,46,20,27,53,49,35,56,52,41,59
Netherlands,NL,NLD,Europe,2107,1,1,1,0,0,0,1,1,1,0,0,0,1,1,1,0
Netherlands,NL,NLD,Europe,2099,1,1,0,0,1,0,0,1,0,1,0,1,1,0,1,1
Netherlands,NL,NLD,Europe,2019,11575,4798,400,3153,2117,1741,3442,2517,2141,3572,4090,3858,3861,4379,4258,4509
Netherlands,NL,NLD,Europe,2018,57761,26364,2836,21219,10505,8460,22658,13341,11296,22792,23353,18965,24231,24792,21801,24926
Netherlands,NL,NLD,Europe,2017,59904,31613,6100,25334,9633,8443,28741,15733,14543,26328,27214,18076,29735,30621,24176,28208
Netherlands,NL,NLD,Europe,2016,55923,29654,6255,22859,8248,8213,26234,14503,14468,23767,25373,16461,27142,28748,22716,26281
Netherlands,NL,NLD,Europe,2015,53234,26413,6125,20050,7738,6663,23424,13863,12788,20725,22365,14401,24099,25739,20526,23040
Netherlands,NL,NLD,Europe,2014,52523,23417,6542,17106,6619,4351,20683,13161,10893,17787,19159,10970,21364,22736,17512,19840
Netherlands,NL,NLD,Europe,2013,51913,22390,6804,15822,5702,4119,19754,12506,10923,16377,17905,9821,20309,21837,16625,18460
Netherlands,NL,NLD,Europe,2012,48838,21350,6770,15271,4548,4667,18897,11318,11437,15756,17239,9215,19382,20865,15985,17724
Netherlands,NL,NLD,Europe,2011,45610,20104,6522,14217,3428,4988,17881,9950,11510,14546,16112,8416,18210,19776,14938,16441
Netherlands,NL,NLD,Europe,2010,47079,18554,6508,13051,2763,3869,16716,9271,10377,13588,14352,6632,17253,18017,13140,14889
Netherlands,NL,NLD,Europe,2009,40794,16273,6111,11262,1954,3130,14750,8065,9241,11580,12468,5084,15068,15956,11195,12786
Norway,NO,NOR,Europe,2019,3794,1432,138,918,818,339,1034,956,477,1131,1103,1157,1247,1219,1295,1316
Norway,NO,NOR,Europe,2018,18890,8549,902,6748,4348,1656,7317,5250,2558,7538,7190,6004,8107,7759,6906,7980
Norway,NO,NOR,Europe,2017,20194,11191,1850,8748,4057,2214,9906,5907,4064,9361,9421,6271,10519,10579,8121,10034
Norway,NO,NOR,Europe,2016,17938,9813,1868,7305,3409,2071,8438,5277,3939,7912,8073,5480,9045,9206,7348,8680
Norway,NO,NOR,Europe,2015,16315,8589,1856,6322,2908,1746,7537,4764,3602,6719,6977,4654,7934,8192,6510,7374
Norway,NO,NOR,Europe,2014,16119,8259,2004,6009,2661,1559,7288,4665,3563,6382,6608,4220,7661,7887,6224,6981
Norway,NO,NOR,Europe,2013,15527,7211,2112,4893,2119,1232,6367,4231,3344,5241,5390,3351,6715,6864,5463,5738
Norway,NO,NOR,Europe,2012,14905,6559,2230,4218,1763,1072,5787,3993,3302,4554,4654,2835,6123,6223,5065,4990
Norway,NO,NOR,Europe,2011,13865,5875,2261,3686,1276,1013,5246,3537,3274,3913,4088,2289,5473,5648,4550,4315
Norway,NO,NOR,Europe,2010,12569,4966,1958,3022,1112,669,4409,3070,2627,3296,3305,1781,4683,4692,3739,3579
Norway,NO,NOR,Europe,2009,14769,4450,1925,2453,807,641,3849,2732,2566,2671,2837,1448,4067,4233,3373,3055
Poland,PL,POL,Europe,2019,6271,2847,178,1759,1729,681,1910,1907,859,2295,2160,2410,2446,2311,2588,2696
Poland,PL,POL,Europe,2018,33274,15469,1794,8926,8564,3430,10282,10358,5224,12283,10756,11994,13639,12112,13788,14113
Poland,PL,POL,Europe,2017,35574,19165,3124,9010,8740,5162,11501,11864,8286,13478,12206,13902,15969,14697,17026,16674
Poland,PL,POL,Europe,2016,34203,18010,3306,8285,7676,4942,10882,10982,8248,12369,11329,12618,14966,13926,15924,15413
Poland,PL,POL,Europe,2015,32347,16692,2919,7456,7702,4120,9661,10621,7039,11925,10018,11822,14130,12223,14741,14487
Poland,PL,POL,Europe,2014,28234,14226,2441,6643,6135,3703,8353,8576,6144,10225,8934,9838,11935,10644,12279,12516
Poland,PL,POL,Europe,2013,24875,11527,3129,5376,3763,3025,7775,6892,6154,7467,7037,6788,9866,9436,9917,9128
Poland,PL,POL,Europe,2012,20762,9607,2969,4528,2594,2581,6719,5563,5550,6039,5905,5175,8230,8096,8144,7416
Poland,PL,POL,Europe,2011,17506,7222,2396,3471,1657,1851,5200,4053,4247,4483,4481,3508,6212,6210,5904,5493
Poland,PL,POL,Europe,2010,15755,5653,2225,2904,1021,1085,4456,3246,3310,3458,3547,2106,5010,5099,4331,4101
Poland,PL,POL,Europe,2009,14643,4446,1900,2304,642,678,3622,2542,2578,2632,2800,1320,3950,4118,3220,3128
Portugal,PT,PRT,Europe,2020,1,1,0,1,0,1,1,0,1,1,1,1,1,1,1,1
Portugal,PT,PRT,Europe,2019,3825,1320,86,851,885,181,916,971,267,1157,949,1066,1222,1014,1152,1255
Portugal,PT,PRT,Europe,2018,19821,8334,804,5500,4781,1281,6010,5585,2085,7235,6089,6062,7745,6599,6866,7824
Portugal,PT,PRT,Europe,2017,20859,10092,1524,6759,4421,1611,7733,5945,3135,8289,7588,6032,9263,8562,7556,9118
Portugal,PT,PRT,Europe,2016,19288,9558,1405,6544,3738,1727,7441,5143,3132,7751,7455,5465,8648,8352,6870,8662
Portugal,PT,PRT,Europe,2015,18013,8900,1393,6026,3319,1704,6870,4712,3097,7043,7040,5023,7887,7884,6416,8057
Portugal,PT,PRT,Europe,2014,17986,8452,1385,5842,2878,1524,6615,4263,2909,6769,6754,4402,7542,7527,5787,7681
Portugal,PT,PRT,Europe,2013,17014,7583,1582,5162,2247,1246,6110,3829,2828,5921,5876,3493,6869,6824,5075,6635
Portugal,PT,PRT,Europe,2012,15353,6849,1376,4525,2042,1418,5295,3418,2794,5329,5278,3460,6099,6048,4836,6082
Portugal,PT,PRT,Europe,2011,12553,4939,1124,3366,1319,734,4007,2443,1858,3884,3780,2053,4525,4421,3177,4298
Portugal,PT,PRT,Europe,2010,11414,4278,1122,2966,1068,440,3573,2190,1562,3407,3230,1508,4014,3837,2630,3671
Portugal,PT,PRT,Europe,2009,10217,3713,1017,2572,702,441,3185,1719,1458,2867,2806,1143,3480,3419,2160,3101
Romania,RO,ROU,Europe,2103,1,1,0,1,0,0,1,0,0,1,1,0,1,1,0,1
Romania,RO,ROU,Europe,2048,1,0,0,0,0,0,0,0,0,0,0,0,0,0,0,0
Romania,RO,ROU,Europe,2019,837,399,43,214,251,71,249,294,114,334,244,322,369,279,365,364
Romania,RO,ROU,Europe,2018,4783,2239,265,1168,1275,486,1372,1540,751,1748,1455,1761,1952,1659,2026,2035
Romania,RO,ROU,Europe,2017,5214,2743,487,1327,1207,718,1738,1694,1205,1808,1851,1925,2219,2262,2412,2332
Romania,RO,ROU,Europe,2016,4977,2451,390,1112,968,762,1422,1358,1152,1566,1687,1730,1876,1997,2120,2141
Romania,RO,ROU,Europe,2015,5935,2963,470,1064,909,1257,1446,1379,1727,1522,2123,2166,1904,2505,2636,2581
Romania,RO,ROU,Europe,2014,5348,2695,318,1023,903,1183,1271,1221,1501,1413,2057,2086,1661,2305,2404,2447
Romania,RO,ROU,Europe,2013,4685,2055,403,834,623,787,1178,1026,1190,1140,1405,1410,1484,1749,1813,1711
Romania,RO,ROU,Europe,2012,3756,1659,319,668,314,821,916,633,1140,864,1215,1135,1112,1463,1454,1411
Romania,RO,ROU,Europe,2011,2990,1137,281,564,192,455,767,473,736,693,805,647,896,1008,928,934
Romania,RO,ROU,Europe,2010,2648,874,256,421,181,193,613,437,449,544,559,374,736,751,630,682
Romania,RO,ROU,Europe,2009,2321,743,228,407,96,167,590,324,395,460,507,263,643,690,491,560
Russia,RU,RUS,Europe,2019,7108,2504,165,1340,1321,671,1477,1486,836,1877,1830,1992,2014,1967,2157,2367
Russia,RU,RUS,Europe,2018,51968,15667,1741,8700,7742,3554,10015,9483,5295,11839,11214,11296,13154,12529,13037,14353
Russia,RU,RUS,Europe,2017,49694,16459,2586,8664,6028,4735,10740,8614,7321,10926,12121,10763,13002,14197,13349,14383
Russia,RU,RUS,Europe,2016,46919,15459,2402,8698,4825,5175,10477,7227,7577,10242,12137,10000,12021,13916,12402,13681
Russia,RU,RUS,Europe,2015,42818,12511,1961,6792,3162,4549,8175,5123,6510,7965,9955,7711,9348,11338,9672,11128
Russia,RU,RUS,Europe,2014,35860,8544,1621,5038,2221,2344,6129,3842,3965,5834,6658,4565,6925,7749,6186,7454
Russia,RU,RUS,Europe,2013,32111,7167,1600,4776,1358,1516,5816,2958,3116,5269,5635,2874,6309,6675,4474,6128
Russia,RU,RUS,Europe,2012,28678,5906,1793,3694,952,1303,4920,2745,3096,4080,4295,2255,5306,5521,4048,4681
Russia,RU,RUS,Europe,2011,29122,4881,1527,3206,735,870,4211,2262,2397,3524,3560,1605,4529,4565,3132,3878
Russia,RU,RUS,Europe,2010,30566,4500,1483,2953,589,587,3883,2072,2070,3234,3289,1176,4164,4219,2659,3570
Russia,RU,RUS,Europe,2009,27501,4251,1423,2863,465,444,3773,1888,1867,3104,3104,909,4014,4014,2332,3345
Serbia,RS,SRB,Europe,2026,1,1,0,1,0,0,1,0,0,1,1,0,1,1,0,1
Serbia,RS,SRB,Europe,2019,1206,511,57,289,359,63,331,416,120,439,319,422,481,361,479,469
Serbia,RS,SRB,Europe,2018,7260,3487,454,1425,2413,422,1772,2867,876,2931,1634,2835,3278,1981,3289,3140
Serbia,RS,SRB,Europe,2017,7889,4159,768,1624,2607,446,2261,3375,1214,3262,1884,3053,3899,2521,3821,3522
Serbia,RS,SRB,Europe,2016,8124,4214,765,1826,2646,446,2422,3411,1211,3386,2058,3092,3982,2654,3857,3618
Serbia,RS,SRB,Europe,2015,7856,3782,800,1573,2133,502,2209,2933,1302,2806,1913,2635,3442,2549,3435,3146
Serbia,RS,SRB,Europe,2014,7634,3771,767,1462,2188,478,2088,2955,1245,2829,1778,2666,3455,2404,3433,3145
Serbia,RS,SRB,Europe,2013,7110,3108,713,1294,1535,505,1845,2248,1218,2260,1591,2040,2811,2142,2753,2557
Serbia,RS,SRB,Europe,2012,6352,2802,571,1131,1435,506,1589,2006,1077,2085,1390,1941,2543,1848,2512,2344
Serbia,RS,SRB,Europe,2011,5200,2224,445,819,1151,393,1179,1596,838,1645,1038,1544,2005,1398,1989,1864
Serbia,RS,SRB,Europe,2010,4486,1732,346,586,940,256,818,1286,602,1309,777,1196,1541,1009,1542,1500
Serbia,RS,SRB,Europe,2009,4037,1486,324,545,796,170,798,1120,494,1117,661,966,1370,914,1290,1233
Slovakia,SK,SVK,Europe,2019,762,317,26,176,202,71,200,228,97,263,206,273,287,230,299,293
Slovakia,SK,SVK,Europe,2018,4592,2127,418,987,1224,283,1346,1642,701,1629,1126,1507,1988,1485,1925,1768
Slovakia,SK,SVK,Europe,2017,4577,2262,455,982,1065,468,1355,1520,923,1570,1301,1533,1943,1674,1988,1889
Slovakia,SK,SVK,Europe,2016,4424,2200,383,974,1049,490,1276,1432,873,1558,1314,1539,1860,1616,1922,1898
Slovakia,SK,SVK,Europe,2015,4182,2008,330,836,919,510,1094,1249,840,1378,1208,1429,1636,1466,1759,1750
Slovakia,SK,SVK,Europe,2014,4404,1967,511,763,740,494,1164,1251,1005,1181,1149,1234,1582,1550,1745,1567
Slovakia,SK,SVK,Europe,2013,3603,1584,417,610,584,389,966,1001,806,966,872,973,1322,1228,1390,1228
Slovakia,SK,SVK,Europe,2012,3062,1478,425,601,358,517,941,783,942,829,912,875,1169,1252,1300,1140
Slovakia,SK,SVK,Europe,2011,2496,989,266,505,290,259,690,556,525,670,639,549,855,824,815,804
Slovakia,SK,SVK,Europe,2010,2375,915,354,420,184,188,693,538,542,510,552,372,783,825,726,642
Slovakia,SK,SVK,Europe,2009,2200,786,289,407,130,162,610,419,451,464,526,292,667,729,581,583
Slovenia,SI,SVN,Europe,2019,794,354,23,201,224,69,216,247,92,301,239,293,316,254,316,339
Slovenia,SI,SVN,Europe,2018,4039,1818,218,1163,1026,309,1321,1244,527,1537,1286,1335,1695,1444,1553,1660
Slovenia,SI,SVN,Europe,2017,3918,1968,342,1192,956,297,1423,1298,639,1597,1333,1253,1828,1564,1595,1738
Slovenia,SI,SVN,Europe,2016,3822,1907,332,1190,931,323,1413,1263,655,1533,1341,1254,1756,1564,1586,1684
Slovenia,SI,SVN,Europe,2015,3750,1793,300,1087,893,314,1286,1193,614,1429,1252,1207,1628,1451,1507,1594
Slovenia,SI,SVN,Europe,2014,3604,1618,356,949,741,241,1208,1097,597,1231,1078,982,1490,1337,1338,1360
Slovenia,SI,SVN,Europe,2013,3487,1435,317,839,613,226,1050,930,543,1118,945,839,1329,1156,1156,1224
Slovenia,SI,SVN,Europe,2012,3161,1427,332,872,512,314,1086,844,646,1091,994,826,1305,1208,1158,1213
Slovenia,SI,SVN,Europe,2011,2989,1155,321,648,351,247,861,672,568,825,765,598,1038,978,919,942
Slovenia,SI,SVN,Europe,2010,2534,934,235,525,313,163,679,548,398,688,618,476,842,772,711,781
Slovenia,SI,SVN,Europe,2009,2518,832,222,464,224,167,594,446,389,602,564,391,732,694,613,702
Spain,ES,ESP,Europe,2099,16,15,0,1,15,0,1,15,0,15,1,15,15,1,15,15
Spain,ES,ESP,Europe,2019,15708,5813,360,3846,3793,891,4097,4153,1251,5041,4367,4684,5292,4618,5044,5562
Spain,ES,ESP,Europe,2018,80515,33936,2940,23053,19503,5246,24811,22443,8186,29866,25366,24749,31624,27124,27689,32179
Spain,ES,ESP,Europe,2017,85025,42505,7028,28817,18013,6969,33015,25041,13997,35008,32119,24982,39206,36317,32010,38310
Spain,ES,ESP,Europe,2016,76646,39647,6622,28139,14893,6736,31839,21515,13358,32841,31248,21629,36541,34948,28251,35950
Spain,ES,ESP,Europe,2015,72322,36805,6538,25919,13365,6302,29444,19903,12840,30118,29081,19667,33643,32606,26205,33280
Spain,ES,ESP,Europe,2014,71001,34315,7300,23936,11696,5428,27839,18996,12728,27493,26861,17124,31396,30764,24424,30418
Spain,ES,ESP,Europe,2013,67116,30196,6769,20747,9451,4663,24347,16220,11432,24024,23322,14114,27624,26922,20883,26599
Spain,ES,ESP,Europe,2012,63330,27903,7111,18749,8121,4482,22287,15232,11593,21903,21214,12603,25441,24752,19714,24368
Spain,ES,ESP,Europe,2011,58442,23883,6670,16146,6062,3568,19592,12732,10238,18434,18154,9630,21880,21600,16300,20442
Spain,ES,ESP,Europe,2010,54258,21097,6610,14056,4649,2653,17450,11259,9263,16042,15722,7302,19436,19116,13912,17708
Spain,ES,ESP,Europe,2009,49411,17518,5888,11287,3399,2351,14498,9287,8239,12824,12773,5750,16035,15984,11638,14310
Sweden,SE,SWE,Europe,2019,7964,3414,397,2262,1623,1028,2537,2020,1425,2604,2797,2651,2879,3072,3048,3139
Sweden,SE,SWE,Europe,2018,38992,18005,1998,14033,8080,4867,15109,10078,6865,15323,15639,12947,16399,16715,14945,16929
Sweden,SE,SWE,Europe,2017,40456,20888,3626,16065,7290,5481,18223,10916,9107,16969,17828,12771,19127,19986,16397,18732
Sweden,SE,SWE,Europe,2016,37605,19728,3794,15263,6399,4817,17344,10193,8611,15976,16935,11216,18057,19016,15010,17648
Sweden,SE,SWE,Europe,2015,35930,18298,3952,13948,5852,4004,16157,9804,7956,14617,15421,9856,16826,17630,13808,16090
Sweden,SE,SWE,Europe,2014,34895,17120,3866,13034,5271,3515,15133,9137,7381,13631,14430,8786,15730,16529,12652,15027
Sweden,SE,SWE,Europe,2013,33646,15533,4071,11596,4298,2751,13893,8369,6822,12086,12750,7049,14383,15047,11120,13240
Sweden,SE,SWE,Europe,2012,31027,13687,4210,9909,3571,2158,12296,7781,6368,10396,10817,5729,12783,13204,9939,11304
Sweden,SE,SWE,Europe,2011,28712,11948,4007,8516,2564,1741,10874,6571,5748,8865,9244,4305,11223,11602,8312,9593
Sweden,SE,SWE,Europe,2010,27722,10807,3885,7242,2411,1204,9516,6296,5089,7948,7829,3615,10222,10103,7500,8535
Sweden,SE,SWE,Europe,2009,34104,10109,3920,6010,2311,1085,8488,6231,5005,7100,6548,3396,9578,9026,7316,7638
Switzerland,CH,CHE,Europe,2099,1,0,0,0,0,0,0,0,0,0,0,0,0,0,0,0
Switzerland,CH,CHE,Europe,2019,7842,3103,255,2215,1559,772,2415,1814,1027,2524,2595,2331,2724,2795,2586,2904
Switzerland,CH,CHE,Europe,2018,39524,17339,1584,14274,7991,3525,15185,9575,5109,15458,15246,11516,16369,16157,13100,16430
Switzerland,CH,CHE,Europe,2017,42298,21888,3942,17460,7486,4196,19640,11428,8138,18420,18750,11682,20600,20930,15624,19710
Switzerland,CH,CHE,Europe,2016,38730,21215,4141,16725,6748,4308,18793,10889,8449,17608,18267,11056,19676,20335,15197,19150
Switzerland,CH,CHE,Europe,2015,37435,19876,4139,15601,6140,3921,17599,10279,8060,16428,17053,10061,18426,19051,14200,17880
Switzerland,CH,CHE,Europe,2014,36034,18122,4360,14095,5095,3096,16155,9455,7456,14780,15380,8191,16840,17440,12551,16065
Switzerland,CH,CHE,Europe,2013,35047,17127,4350,13392,4137,2863,15423,8487,7213,14032,14458,7000,16063,16489,11350,15098
Switzerland,CH,CHE,Europe,2012,32953,16040,4636,12457,3151,2596,14533,7787,7232,13015,13406,5747,15091,15482,10383,13964
Switzerland,CH,CHE,Europe,2011,30625,14212,4439,11028,2421,2118,12989,6860,6557,11403,11876,4539,13364,13837,8978,12251
Switzerland,CH,CHE,Europe,2010,29233,13156,4571,10074,1784,1334,12153,6355,5905,10487,10664,3118,12566,12743,7689,11077
Switzerland,CH,CHE,Europe,2009,27265,11786,4282,9023,1304,1041,11048,5586,5323,9284,9502,2345,11309,11527,6627,9763
Ukraine,UA,UKR,Europe,2019,816,347,57,167,176,75,221,233,132,253,207,251,307,261,308,293
Ukraine,UA,UKR,Europe,2018,7205,3317,468,1154,1683,860,1549,2151,1328,2265,1811,2543,2660,2206,3011,2922
Ukraine,UA,UKR,Europe,2017,6509,3495,330,1217,1724,1108,1475,2054,1438,2335,2119,2832,2593,2377,3162,3237
Ukraine,UA,UKR,Europe,2016,6074,3179,329,1186,1501,968,1431,1830,1297,2167,1953,2469,2412,2198,2798,2934
Ukraine,UA,UKR,Europe,2015,5284,2373,259,927,1184,625,1141,1443,884,1712,1374,1809,1926,1588,2068,2159
Ukraine,UA,UKR,Europe,2014,5131,2052,258,845,880,585,1039,1138,843,1427,1276,1465,1621,1470,1723,1858
Ukraine,UA,UKR,Europe,2013,4212,1286,204,669,463,351,819,667,555,996,809,814,1146,959,1018,1136
Ukraine,UA,UKR,Europe,2012,3575,1038,200,590,293,301,727,493,501,792,699,594,929,836,794,901
Ukraine,UA,UKR,Europe,2011,3451,751,163,468,174,172,583,337,335,564,540,346,679,655,509,636
Ukraine,UA,UKR,Europe,2010,3414,717,218,451,150,97,584,368,315,527,508,247,660,641,465,584
Ukraine,UA,UKR,Europe,2009,3019,620,184,360,133,80,482,317,264,447,411,213,569,533,397,498
United Kingdom,GB,GBR,Europe,2108,1,1,0,0,1,0,0,1,0,1,0,1,1,0,1,1
United Kingdom,GB,GBR,Europe,2099,2,2,0,0,2,0,0,2,0,2,0,2,2,0,2,2
United Kingdom,GB,GBR,Europe,2038,1,1,0,1,0,1,1,0,1,1,1,1,1,1,1,1
United Kingdom,GB,GBR,Europe,2023,2,0,0,0,0,0,0,0,0,0,0,0,0,0,0,0
United Kingdom,GB,GBR,Europe,2019,40303,15354,1399,11403,6617,4565,12308,8016,5964,12675,13178,11182,13580,14083,12581,14450
United Kingdom,GB,GBR,Europe,2018,200052,91464,9206,76715,34139,22810,81447,43345,32016,82134,81318,56949,86866,86050,66155,86737
United Kingdom,GB,GBR,Europe,2017,207094,123866,18685,104271,31447,27109,113909,50132,45794,108569,109936,58556,118207,119574,77241,114234
United Kingdom,GB,GBR,Europe,2016,196559,118127,19329,98810,27500,26968,107979,46829,46297,102268,105506,54468,111437,114675,73797,108964
United Kingdom,GB,GBR,Europe,2015,189159,102768,21017,81731,25534,22492,93052,46551,43509,84697,88486,48026,96018,99807,69043,91452
United Kingdom,GB,GBR,Europe,2014,182424,89900,22023,69446,20676,19059,80702,42699,41082,72117,75978,39735,83373,87234,61758,78649
United Kingdom,GB,GBR,Europe,2013,181746,79225,23186,57999,17425,14880,70956,40611,38066,60376,63899,32305,73333,76856,55491,66276
United Kingdom,GB,GBR,Europe,2012,170462,67962,23401,48432,13449,11383,60818,36850,34784,50550,53461,24832,62936,65847,48233,55579
United Kingdom,GB,GBR,Europe,2011,162719,61553,23411,42328,10270,9179,55646,33681,32590,43948,46619,19449,57266,59937,42860,48239
United Kingdom,GB,GBR,Europe,2010,158126,57680,22765,38971,8960,7457,51647,31725,30222,41456,42522,16417,54132,55198,39182,45007
United Kingdom,GB,GBR,Europe,2009,153440,51654,21437,34521,6210,6847,47019,27647,28284,35870,37809,13057,48368,50307,34494,39158
Vatican,VA,VAT,Europe,2019,1,1,0,1,1,0,1,1,0,1,1,1,1,1,1,1
Vatican,VA,VAT,Europe,2018,2,1,0,1,0,0,1,0,0,1,1,0,1,1,0,1
Vatican,VA,VAT,Europe,2017,1,1,0,1,1,0,1,1,0,1,1,1,1,1,1,1
Vatican,VA,VAT,Europe,2016,1,1,1,0,0,0,1,1,1,0,0,0,1,1,1,0
Vatican,VA,VAT,Europe,2013,2,0,0,0,0,0,0,0,0,0,0,0,0,0,0,0
Vatican,VA,VAT,Europe,2012,2,0,0,0,0,0,0,0,0,0,0,0,0,0,0,0
Vatican,VA,VAT,Europe,2011,2,0,0,0,0,0,0,0,0,0,0,0,0,0,0,0
Vatican,VA,VAT,Europe,2010,1,0,0,0,0,0,0,0,0,0,0,0,0,0,0,0
Australia,AU,AUS,Oceania,2108,1,0,0,0,0,0,0,0,0,0,0,0,0,0,0,0
Australia,AU,AUS,Oceania,2103,1,1,0,0,1,0,0,1,0,1,0,1,1,0,1,1
Australia,AU,AUS,Oceania,2020,1,1,1,0,0,0,1,1,1,0,0,0,1,1,1,0
Australia,AU,AUS,Oceania,2019,20932,5581,593,3733,3248,1058,4188,3841,1651,4500,4359,4306,4955,4814,4899,5126
Australia,AU,AUS,Oceania,2018,100067,30876,3895,22924,16716,4937,25517,20611,8832,26274,24936,21653,28867,27529,25548,28286
Australia,AU,AUS,Oceania,2017,103284,39813,8431,28436,15161,6622,33889,23592,15053,31254,31543,21783,36707,36996,30214,34361
Australia,AU,AUS,Oceania,2016,95826,39291,9205,28330,13556,6172,34127,22761,15377,30710,31117,19728,36507,36914,28933,33497
Australia,AU,AUS,Oceania,2015,90759,36511,9739,26040,12123,5579,32100,21862,15318,27804,28688,17702,33864,34748,27441,30452
Australia,AU,AUS,Oceania,2014,86577,32976,9715,23247,10211,4615,29109,19926,14330,24853,25511,14826,30715,31373,24541,27117
Australia,AU,AUS,Oceania,2013,82858,30122,9872,20757,8524,3977,26977,18396,13849,21921,22739,12501,28141,28959,22373,23903
Australia,AU,AUS,Oceania,2012,74298,25211,9367,16727,6471,3329,22449,15838,12696,17790,18429,9800,23512,24151,19167,19492
Australia,AU,AUS,Oceania,2011,68367,21553,9079,13689,4459,2689,19369,13538,11768,14452,15112,7148,20132,20792,16227,15875
Australia,AU,AUS,Oceania,2010,64644,19083,8813,11491,3261,2000,17154,12074,10813,12336,12577,5261,17999,18240,14074,13422
Australia,AU,AUS,Oceania,2009,59510,16820,8001,10214,2196,1925,15277,10197,9926,10701,11271,4121,15764,16334,12122,11758
Fiji,FJ,FJI,Oceania,2019,65,21,4,9,14,1,13,18,5,16,10,15,20,14,19,17
Fiji,FJ,FJI,Oceania,2018,285,102,20,48,50,22,67,70,42,64,67,72,83,86,92,83
Fiji,FJ,FJI,Oceania,2017,292,131,30,75,49,34,93,79,64,88,100,83,106,118,113,113
Fiji,FJ,FJI,Oceania,2016,218,79,21,40,38,10,59,59,31,54,46,48,73,65,69,60
Fiji,FJ,FJI,Oceania,2015,180,54,11,29,22,10,38,33,21,38,36,32,47,45,43,45
Fiji,FJ,FJI,Oceania,2014,203,68,13,33,24,19,44,37,32,45,45,43,56,56,56,57
Fiji,FJ,FJI,Oceania,2013,205,55,15,27,16,14,41,31,29,31,37,30,45,51,45,41
Fiji,FJ,FJI,Oceania,2012,191,52,23,27,13,7,44,36,30,29,33,20,46,50,43,35
Fiji,FJ,FJI,Oceania,2011,118,28,16,13,4,3,25,20,19,15,14,7,27,26,23,16
Fiji,FJ,FJI,Oceania,2010,116,32,12,17,3,2,27,15,14,20,19,5,30,29,17,22
Fiji,FJ,FJI,Oceania,2009,124,34,15,16,2,6,29,17,21,17,20,8,30,33,23,21
French Polynesia,PF,PYF,Oceania,2019,11,5,0,4,5,0,4,5,0,5,4,5,5,4,5,5
French Polynesia,PF,PYF,Oceania,2018,49,20,2,13,12,5,14,14,7,16,16,17,17,17,19,19
French Polynesia,PF,PYF,Oceania,2017,41,28,1,21,11,11,21,12,12,22,27,22,22,27,23,28
French Polynesia,PF,PYF,Oceania,2016,48,32,3,23,12,8,25,15,11,25,28,20,27,30,23,30
French Polynesia,PF,PYF,Oceania,2015,42,25,4,19,8,7,20,12,11,20,23,15,21,24,19,24
French Polynesia,PF,PYF,Oceania,2014,25,12,1,10,6,2,10,7,3,10,12,8,10,12,9,12
French Polynesia,PF,PYF,Oceania,2013,30,11,3,6,2,4,9,5,7,6,8,6,9,11,9,8
French Polynesia,PF,PYF,Oceania,2012,28,9,2,6,2,2,8,4,4,6,7,4,8,9,6,7
French Polynesia,PF,PYF,Oceania,2011,24,11,1,7,5,3,7,6,4,9,9,8,9,9,9,11
French Polynesia,PF,PYF,Oceania,2010,16,5,2,3,0,2,4,2,4,3,4,2,4,5,4,4
French Polynesia,PF,PYF,Oceania,2009,21,5,3,2,1,1,4,4,4,2,3,2,4,5,5,3
New Caledonia,NC,NCL,Oceania,2019,17,8,1,7,4,1,7,5,2,8,7,5,8,7,6,8
New Caledonia,NC,NCL,Oceania,2018,48,23,0,22,8,7,22,8,7,22,23,15,22,23,15,23
New Caledonia,NC,NCL,Oceania,2017,64,33,2,30,12,8,31,14,10,32,30,20,33,31,22,32
New Caledonia,NC,NCL,Oceania,2016,67,41,4,35,13,17,38,17,21,36,37,30,39,40,34,38
New Caledonia,NC,NCL,Oceania,2015,81,39,9,30,10,5,34,19,14,33,32,15,37,36,24,35
New Caledonia,NC,NCL,Oceania,2014,81,50,7,39,23,9,42,30,16,43,43,32,46,46,39,47
New Caledonia,NC,NCL,Oceania,2013,38,16,3,14,7,0,16,10,3,14,14,7,16,16,10,14
New Caledonia,NC,NCL,Oceania,2012,44,17,5,14,7,2,17,12,7,14,14,9,17,17,14,14
New Caledonia,NC,NCL,Oceania,2011,29,12,6,6,2,1,11,8,7,6,7,3,11,12,9,7
New Caledonia,NC,NCL,Oceania,2010,43,16,9,12,2,1,16,11,10,12,12,3,16,16,12,12
New Caledonia,NC,NCL,Oceania,2009,28,8,6,4,0,1,7,6,7,4,5,1,7,8,7,5
New Zealand,NZ,NZL,Oceania,2019,3447,956,88,626,576,166,697,664,254,790,721,742,861,792,830,885
New Zealand,NZ,NZL,Oceania,2018,16856,4948,635,3508,2776,812,3949,3411,1447,4156,3859,3588,4597,4300,4223,4507
New Zealand,NZ,NZL,Oceania,2017,17361,6284,1404,4157,2616,1014,5152,4020,2418,4778,4668,3630,5773,5663,5034,5289
New Zealand,NZ,NZL,Oceania,2016,15674,5868,1433,3968,2153,998,4903,3586,2431,4433,4469,3151,5368,5404,4584,4934
New Zealand,NZ,NZL,Oceania,2015,14777,5299,1415,3633,1928,804,4539,3343,2219,4028,3998,2732,4934,4904,4147,4393
New Zealand,NZ,NZL,Oceania,2014,14143,4709,1462,3113,1528,620,4096,2990,2082,3423,3417,2148,4406,4400,3610,3727
New Zealand,NZ,NZL,Oceania,2013,13926,4599,1544,2863,1306,691,3931,2850,2235,3173,3221,1997,4241,4289,3541,3531
New Zealand,NZ,NZL,Oceania,2012,12676,3847,1503,2334,996,526,3341,2499,2029,2577,2597,1522,3584,3604,3025,2840
New Zealand,NZ,NZL,Oceania,2011,12489,3572,1504,2113,755,455,3136,2259,1959,2310,2352,1210,3333,3375,2714,2549
New Zealand,NZ,NZL,Oceania,2010,11291,3123,1414,1793,548,330,2778,1962,1744,1956,1976,878,2941,2961,2292,2139
New Zealand,NZ,NZL,Oceania,2009,10369,2747,1360,1534,372,283,2478,1732,1643,1649,1688,655,2593,2632,2015,1803
Papua New Guinea,PG,PNG,Oceania,2019,38,17,0,15,15,2,15,15,2,16,16,17,16,16,17,17
Papua New Guinea,PG,PNG,Oceania,2018,160,58,3,40,42,10,42,45,13,53,43,52,55,45,55,56
Papua New Guinea,PG,PNG,Oceania,2017,163,85,13,63,54,14,68,67,27,76,67,68,81,72,81,80
Papua New Guinea,PG,PNG,Oceania,2016,146,86,18,54,30,24,65,48,42,61,68,54,72,79,72,75
Papua New Guinea,PG,PNG,Oceania,2015,148,82,24,59,41,7,71,65,31,67,62,48,79,74,72,70
Papua New Guinea,PG,PNG,Oceania,2014,128,73,16,55,37,10,64,53,26,60,59,47,69,68,63,64
Papua New Guinea,PG,PNG,Oceania,2013,109,66,11,59,40,8,61,51,19,59,64,48,61,66,59,64
Papua New Guinea,PG,PNG,Oceania,2012,105,63,18,52,33,3,60,51,21,53,54,36,61,62,54,55
Papua New Guinea,PG,PNG,Oceania,2011,97,53,22,45,21,6,51,43,28,46,46,27,52,52,49,47
Papua New Guinea,PG,PNG,Oceania,2010,98,46,19,36,19,2,43,38,21,38,37,21,45,44,40,39
Papua New Guinea,PG,PNG,Oceania,2009,75,32,14,24,9,2,32,23,16,24,24,11,32,32,25,24
Samoa,WS,WSM,Oceania,2018,7,1,0,0,1,0,0,1,0,1,0,1,1,0,1,1
Samoa,WS,WSM,Oceania,2017,8,4,2,1,1,1,3,3,3,1,2,2,3,4,4,2
Samoa,WS,WSM,Oceania,2016,11,5,2,3,1,0,5,3,2,3,3,1,5,5,3,3
Samoa,WS,WSM,Oceania,2015,7,4,3,1,0,1,3,3,4,1,2,1,3,4,4,2
Samoa,WS,WSM,Oceania,2014,7,4,1,3,2,0,4,3,1,3,3,2,4,4,3,3
Samoa,WS,WSM,Oceania,2013,3,0,0,0,0,0,0,0,0,0,0,0,0,0,0,0
Samoa,WS,WSM,Oceania,2012,2,2,1,2,0,0,2,1,1,2,2,0,2,2,1,2
Samoa,WS,WSM,Oceania,2011,8,6,3,4,1,1,4,4,4,5,5,2,5,5,5,6
Samoa,WS,WSM,Oceania,2010,4,2,1,1,0,0,2,1,1,1,1,0,2,2,1,1
Samoa,WS,WSM,Oceania,2009,3,3,0,3,1,0,3,1,0,3,3,1,3,3,1,3